,Vendor,Type_of_Spend,Brand,PO_Number,PO_Amount,Invoice_Amount,Difference,Date_Opened
1437,Pinterest Inc,E-Commerce,Space Wars,81808163,149936,64575,85361,2022-11-14
569,TikTok Inc,Media Supported Asset,GI-Bro,11067666,149917,92125,57792,2022-10-19
4052,The Martingale Agency,Influencer,Space Wars,27684641,149788,34045,115743,2022-10-15
810,Meta Platforms,Brand Asset Development,Merf,75874795,149770,51463,98307,2022-11-07
3723,The Martingale Agency,Media Supported Asset,Merf,94171053,149678,12350,137328,2022-10-24
903,TikTok Inc,Media Supported Asset,Transmorphers,20466466,149659,2718,146941,2022-12-29
420,KYG Antler LLC,Media Supported Asset,GI-Bro,81645499,149631,9422,140209,2022-12-03
1100,KYG Antler LLC,Media Supported Asset,Merf,25872075,149534,91467,58067,2022-10-17
4703,Disney Studios,Brand Asset Development,GI-Bro,29580018,149510,46159,103351,2022-10-19
3957,TikTok Inc,Influencer,Space Wars,39617052,149446,14123,135323,2022-11-18
3052,The Martingale Agency,Media Supported Asset,Space Wars,23938424,149329,10861,138468,2022-10-29
953,TikTok Inc,Influencer,Transmorphers,84785157,149312,57915,91397,2022-12-24
353,Disney Studios,Influencer,GI-Bro,24716937,149205,20149,129056,2022-11-11
4479,The Martingale Agency,Media Supported Asset,GI-Bro,96449072,149116,6535,142581,2022-10-08
2431,Pinterest Inc,E-Commerce,Clay-Dough,86851616,149111,23664,125447,2022-12-12
1496,Google Inc.,Brand Publicity,Clay-Dough,35605548,149041,59848,89193,2022-12-07
4681,Google Inc.,Influencer,Space Wars,66127282,148944,82487,66457,2022-10-25
4385,TikTok Inc,E-Commerce,GI-Bro,52699234,148812,64014,84798,2022-11-29
1893,TikTok Inc,Brand Asset Development,GI-Bro,93275368,148678,54830,93848,2022-10-14
4696,Pinterest Inc,Influencer,GI-Bro,22164920,148498,84618,63880,2022-12-05
4844,The Martingale Agency,Influencer,Space Wars,50883218,148495,2243,146252,2022-12-11
777,Google Inc.,Brand Asset Development,Transmorphers,60792112,148475,8576,139899,2022-10-22
2436,Google Inc.,Influencer,Transmorphers,60543391,148467,25162,123305,2022-10-20
1970,KYG Antler LLC,Media Supported Asset,Merf,95263645,148420,90851,57569,2022-11-05
2852,Pinterest Inc,Influencer,Transmorphers,85863727,148375,92578,55797,2022-11-25
1161,Disney Studios,E-Commerce,Merf,15250491,148345,82655,65690,2022-11-29
1714,TikTok Inc,Brand Asset Development,GI-Bro,12410748,148335,64017,84318,2022-10-05
680,Nintendo Technologies,Influencer,Space Wars,25028848,148318,8882,139436,2022-12-24
3401,Pinterest Inc,Media Supported Asset,Merf,78545381,148080,24682,123398,2022-10-24
1233,Disney Studios,Brand Asset Development,Transmorphers,60750354,147981,26605,121376,2022-10-31
3336,Pinterest Inc,Brand Asset Development,Transmorphers,99724520,147964,30207,117757,2022-12-29
3025,Pinterest Inc,E-Commerce,Space Wars,37811854,147953,55723,92230,2022-11-08
2391,Pinterest Inc,Influencer,Merf,63549143,147881,33733,114148,2022-12-24
649,The Martingale Agency,Media Supported Asset,Clay-Dough,18507084,147854,81139,66715,2022-12-25
4877,Disney Studios,Media Supported Asset,Merf,63327997,147643,24332,123311,2022-11-16
33,TikTok Inc,Brand Asset Development,Space Wars,40066388,147473,77533,69940,2022-10-12
2203,Pinterest Inc,Media Supported Asset,Clay-Dough,34670479,147341,64177,83164,2022-12-26
402,Pinterest Inc,E-Commerce,Transmorphers,73151072,147305,61090,86215,2022-12-25
1715,Pinterest Inc,Influencer,Clay-Dough,73635101,147091,49740,97351,2022-11-22
142,KYG Antler LLC,Influencer,Clay-Dough,49136816,147080,87243,59837,2022-10-16
1668,TikTok Inc,Media Supported Asset,Space Wars,86397187,147066,33461,113605,2022-11-27
1234,Pinterest Inc,E-Commerce,Clay-Dough,33399281,147052,5386,141666,2022-10-28
2789,KYG Antler LLC,Brand Asset Development,Transmorphers,76439700,147049,88686,58363,2022-12-22
2189,The Martingale Agency,Brand Asset Development,GI-Bro,92467939,147025,27482,119543,2022-10-05
3573,The Martingale Agency,E-Commerce,Clay-Dough,39511490,146994,11537,135457,2022-10-28
1137,Pinterest Inc,Influencer,Space Wars,80287357,146979,55034,91945,2022-12-26
2325,TikTok Inc,Brand Publicity,Space Wars,81860337,146932,94881,52051,2022-12-18
954,TikTok Inc,Influencer,GI-Bro,77110074,146891,25135,121756,2022-12-11
1057,TikTok Inc,Brand Publicity,Space Wars,26191661,146688,89628,57060,2022-12-01
2974,Disney Studios,Media Supported Asset,Clay-Dough,40740356,146652,3418,143234,2022-10-21
3527,KYG Antler LLC,Media Supported Asset,Clay-Dough,58002557,146641,11950,134691,2022-10-13
524,The Martingale Agency,Brand Asset Development,Space Wars,78091562,146515,67093,79422,2022-12-03
3489,Google Inc.,E-Commerce,Merf,31571598,146468,52678,93790,2022-12-04
4346,Pinterest Inc,E-Commerce,Transmorphers,84217060,146343,68358,77985,2022-11-01
2641,Nintendo Technologies,Brand Publicity,Merf,86684455,146312,48079,98233,2022-11-22
4674,Google Inc.,E-Commerce,Transmorphers,73640465,146299,89706,56593,2022-11-30
1175,KYG Antler LLC,Brand Asset Development,GI-Bro,88302576,146237,4765,141472,2022-12-14
3632,Meta Platforms,Influencer,Clay-Dough,74695558,146217,26524,119693,2022-11-28
677,TikTok Inc,Brand Asset Development,Transmorphers,31471417,146123,95510,50613,2022-10-25
2053,Disney Studios,Brand Asset Development,GI-Bro,13340203,146094,58364,87730,2022-10-29
1043,Meta Platforms,Brand Publicity,Clay-Dough,30743416,145901,3348,142553,2022-10-22
4662,TikTok Inc,Media Supported Asset,Space Wars,78082756,145882,45263,100619,2022-10-07
3059,KYG Antler LLC,Brand Publicity,Merf,97533430,145757,71290,74467,2022-11-13
2502,Google Inc.,Influencer,GI-Bro,71374302,145605,74783,70822,2022-12-13
3786,Disney Studios,E-Commerce,GI-Bro,23076469,145604,93710,51894,2022-12-01
3793,Pinterest Inc,Brand Asset Development,GI-Bro,37782637,145547,33494,112053,2022-12-19
2469,Google Inc.,Brand Asset Development,Transmorphers,12749144,145511,82130,63381,2022-12-18
1634,KYG Antler LLC,Influencer,Merf,72295744,145484,57146,88338,2022-11-27
638,Meta Platforms,Media Supported Asset,Clay-Dough,71333257,145473,41969,103504,2022-12-06
4120,Disney Studios,Brand Asset Development,Clay-Dough,95302630,145416,3241,142175,2022-11-18
2582,Nintendo Technologies,Influencer,Transmorphers,47553351,145332,17135,128197,2022-11-27
3162,TikTok Inc,E-Commerce,GI-Bro,42572895,145127,34658,110469,2022-11-07
4872,Pinterest Inc,E-Commerce,Merf,24211778,144797,41530,103267,2022-10-21
1054,The Martingale Agency,E-Commerce,Transmorphers,23395927,144754,79095,65659,2022-10-02
3604,Google Inc.,E-Commerce,Clay-Dough,81803904,144590,80176,64414,2022-12-07
4318,Disney Studios,E-Commerce,Clay-Dough,99152342,144577,25814,118763,2022-11-21
917,Pinterest Inc,Influencer,Clay-Dough,98370312,144487,73909,70578,2022-10-30
4254,TikTok Inc,Brand Publicity,Space Wars,77136762,144342,72460,71882,2022-10-12
2402,Disney Studios,Influencer,Merf,39891428,144230,70084,74146,2022-10-24
4367,The Martingale Agency,Brand Asset Development,Space Wars,74118796,144213,78773,65440,2022-12-07
500,Disney Studios,Brand Asset Development,Clay-Dough,41901307,144209,76340,67869,2022-12-27
2371,The Martingale Agency,Influencer,GI-Bro,82784375,144146,20383,123763,2022-11-21
2785,Nintendo Technologies,E-Commerce,Merf,93286590,144084,90641,53443,2022-11-08
3696,TikTok Inc,Brand Publicity,Space Wars,96899271,144027,3843,140184,2022-12-26
4220,KYG Antler LLC,Media Supported Asset,Space Wars,31357037,143584,59275,84309,2022-12-02
3912,KYG Antler LLC,Influencer,Clay-Dough,36218023,143457,1716,141741,2022-11-14
2042,Disney Studios,Media Supported Asset,Space Wars,60823282,143407,14026,129381,2022-12-27
1134,Disney Studios,Influencer,Space Wars,76363168,143346,68130,75216,2022-11-28
2414,Nintendo Technologies,Media Supported Asset,Space Wars,60342686,143335,34054,109281,2022-11-03
2271,The Martingale Agency,Brand Asset Development,Transmorphers,39038943,143303,76668,66635,2022-12-09
3395,Disney Studios,Influencer,Space Wars,10478000,143074,18225,124849,2022-10-20
3200,Meta Platforms,Brand Publicity,Transmorphers,75654555,142969,33355,109614,2022-11-03
66,Pinterest Inc,Brand Asset Development,Space Wars,42808007,142920,19333,123587,2022-12-02
3463,Nintendo Technologies,E-Commerce,Merf,80784863,142913,15326,127587,2022-11-23
2709,Nintendo Technologies,Media Supported Asset,GI-Bro,35212875,142720,5002,137718,2022-11-27
2708,TikTok Inc,Influencer,Merf,59582245,142633,41132,101501,2022-11-26
745,The Martingale Agency,Influencer,Merf,40500491,142602,84748,57854,2022-11-10
2124,KYG Antler LLC,E-Commerce,Transmorphers,16353281,142547,56357,86190,2022-12-29
2044,The Martingale Agency,Media Supported Asset,Clay-Dough,35648508,142534,53187,89347,2022-10-05
4530,TikTok Inc,Influencer,Transmorphers,41125214,142475,80550,61925,2022-12-12
1699,Nintendo Technologies,E-Commerce,GI-Bro,97128524,142394,64745,77649,2022-10-02
713,KYG Antler LLC,Media Supported Asset,Transmorphers,52382852,142325,29062,113263,2022-10-28
3657,Disney Studios,Brand Publicity,GI-Bro,89815020,142209,12052,130157,2022-12-12
358,Google Inc.,E-Commerce,Transmorphers,18813854,142195,39869,102326,2022-12-28
3812,Google Inc.,E-Commerce,Merf,38213498,142121,35736,106385,2022-10-14
2226,Pinterest Inc,Brand Asset Development,Space Wars,89558344,142064,26487,115577,2022-10-06
1339,Disney Studios,Media Supported Asset,GI-Bro,98816795,142039,88455,53584,2022-11-21
2101,Pinterest Inc,Brand Publicity,Merf,54811219,141888,47457,94431,2022-10-06
1853,Google Inc.,Brand Asset Development,Transmorphers,94785578,141637,24440,117197,2022-12-20
175,Pinterest Inc,Media Supported Asset,GI-Bro,41780747,141523,8599,132924,2022-11-23
4757,Google Inc.,Brand Asset Development,GI-Bro,23702057,141480,85285,56195,2022-11-20
2511,Nintendo Technologies,Brand Publicity,GI-Bro,91423641,141317,7400,133917,2022-10-28
889,The Martingale Agency,Influencer,Space Wars,10493000,141305,39668,101637,2022-10-13
4350,TikTok Inc,Media Supported Asset,Merf,26780981,141263,59610,81653,2022-11-21
2129,Disney Studios,Brand Publicity,Clay-Dough,12572674,141241,63088,78153,2022-11-05
952,TikTok Inc,Influencer,Space Wars,50602657,141190,75646,65544,2022-11-29
1035,Nintendo Technologies,Brand Asset Development,Transmorphers,90597652,141098,62628,78470,2022-12-11
3814,The Martingale Agency,Brand Publicity,GI-Bro,39647997,141049,19181,121868,2022-10-17
3144,The Martingale Agency,Brand Asset Development,Clay-Dough,18140511,141025,35645,105380,2022-10-05
4401,Google Inc.,E-Commerce,Merf,34480420,141021,42279,98742,2022-12-15
172,TikTok Inc,Brand Publicity,Merf,48327221,140985,58636,82349,2022-11-24
3824,Nintendo Technologies,E-Commerce,Clay-Dough,75820324,140973,68730,72243,2022-11-04
684,KYG Antler LLC,Media Supported Asset,Merf,68480198,140747,10128,130619,2022-10-20
2276,Nintendo Technologies,E-Commerce,GI-Bro,23927679,140674,13044,127630,2022-10-13
2898,Nintendo Technologies,E-Commerce,Transmorphers,38308730,140563,51315,89248,2022-12-28
3776,Nintendo Technologies,Brand Asset Development,Space Wars,13665345,140308,5875,134433,2022-11-14
3032,Nintendo Technologies,Influencer,GI-Bro,98777108,140221,87736,52485,2022-10-19
3,Pinterest Inc,Influencer,Space Wars,46632212,140180,84598,55582,2022-11-07
622,Pinterest Inc,Brand Publicity,Transmorphers,67667534,140179,16988,123191,2022-11-03
1131,Pinterest Inc,Media Supported Asset,Transmorphers,66221920,140070,59071,80999,2022-12-29
2547,Pinterest Inc,Brand Asset Development,Clay-Dough,98715961,139889,79170,60719,2022-10-20
2125,Pinterest Inc,Media Supported Asset,GI-Bro,32865182,139859,29765,110094,2022-10-18
844,Pinterest Inc,Brand Asset Development,Space Wars,74288678,139833,40534,99299,2022-10-11
1811,Disney Studios,Brand Publicity,Space Wars,38239700,139808,6554,133254,2022-11-10
2349,The Martingale Agency,E-Commerce,Clay-Dough,77585029,139709,19100,120609,2022-11-23
3731,Pinterest Inc,Brand Publicity,Merf,41385760,139705,36710,102995,2022-10-20
1073,Google Inc.,Influencer,Transmorphers,51921549,139456,87165,52291,2022-10-06
551,Nintendo Technologies,Brand Publicity,GI-Bro,10197718,139414,31551,107863,2022-10-10
3674,Disney Studios,Media Supported Asset,Transmorphers,32871839,139412,53548,85864,2022-12-08
2745,Google Inc.,Media Supported Asset,Space Wars,57706957,139254,26168,113086,2022-12-24
2328,The Martingale Agency,E-Commerce,Merf,95598087,139202,57028,82174,2022-11-01
2532,Nintendo Technologies,E-Commerce,Space Wars,51645397,138957,32764,106193,2022-11-10
1980,Google Inc.,Brand Asset Development,Merf,55022230,138885,55006,83879,2022-12-22
4084,Nintendo Technologies,E-Commerce,Space Wars,36137626,138879,87660,51219,2022-11-17
428,Nintendo Technologies,Influencer,Transmorphers,19537916,138837,87700,51137,2022-10-14
4243,KYG Antler LLC,Brand Asset Development,Space Wars,61228284,138788,69990,68798,2022-12-11
2069,Google Inc.,Influencer,Transmorphers,90749591,138715,71006,67709,2022-11-22
4038,TikTok Inc,Brand Publicity,Merf,85786937,138645,8882,129763,2022-12-15
1294,KYG Antler LLC,Influencer,Space Wars,97824740,138635,39402,99233,2022-12-22
3500,Nintendo Technologies,Influencer,Transmorphers,84672051,138621,41416,97205,2022-10-06
4601,Pinterest Inc,Influencer,Clay-Dough,70380924,138551,61952,76599,2022-12-27
4360,The Martingale Agency,Influencer,Merf,22754768,138468,41904,96564,2022-10-15
2630,TikTok Inc,Influencer,Clay-Dough,87219282,138332,1258,137074,2022-11-11
3174,Google Inc.,E-Commerce,GI-Bro,43540512,138297,26869,111428,2022-12-05
4315,The Martingale Agency,Influencer,Clay-Dough,41594147,138271,29077,109194,2022-10-02
907,Nintendo Technologies,Brand Asset Development,Clay-Dough,45617354,138260,5169,133091,2022-11-04
1940,Google Inc.,Influencer,GI-Bro,65211378,138157,78219,59938,2022-11-26
1781,TikTok Inc,Media Supported Asset,Clay-Dough,59234990,138120,51053,87067,2022-10-05
2902,KYG Antler LLC,Media Supported Asset,Merf,76935376,138043,11505,126538,2022-11-10
1758,The Martingale Agency,Brand Asset Development,Space Wars,99085809,138018,34136,103882,2022-12-28
2779,Google Inc.,Brand Asset Development,Transmorphers,85135052,137949,82883,55066,2022-10-09
1633,Pinterest Inc,Brand Asset Development,Space Wars,95732646,137806,26330,111476,2022-10-26
1099,Google Inc.,Brand Asset Development,GI-Bro,30926671,137767,45068,92699,2022-11-09
1937,Meta Platforms,Brand Publicity,GI-Bro,74539861,137750,7664,130086,2022-10-22
1901,Disney Studios,Influencer,GI-Bro,28995291,137668,21256,116412,2022-12-19
3600,Nintendo Technologies,Brand Publicity,Space Wars,65852189,137492,26469,111023,2022-11-04
2310,Meta Platforms,Influencer,Merf,19072415,137472,66776,70696,2022-10-20
514,Google Inc.,E-Commerce,Merf,12127040,137382,81530,55852,2022-10-09
100,Pinterest Inc,Brand Publicity,Merf,48588004,137312,43838,93474,2022-12-02
1783,Disney Studios,Influencer,Merf,60318129,137280,82668,54612,2022-11-14
4078,TikTok Inc,Media Supported Asset,Space Wars,24585780,137262,29291,107971,2022-10-18
749,The Martingale Agency,Media Supported Asset,Merf,18163518,137128,49379,87749,2022-11-24
4344,Nintendo Technologies,Influencer,Space Wars,60610485,136909,81827,55082,2022-12-27
2943,The Martingale Agency,Influencer,Space Wars,44140764,136876,39141,97735,2022-10-03
1998,Google Inc.,Brand Asset Development,Space Wars,84500121,136875,69985,66890,2022-11-25
1682,KYG Antler LLC,Brand Publicity,Space Wars,59750777,136683,3912,132771,2022-10-25
2560,Pinterest Inc,Brand Publicity,Transmorphers,33343338,136573,3397,133176,2022-10-03
3183,TikTok Inc,Brand Publicity,Transmorphers,33430741,136302,81813,54489,2022-12-23
4976,The Martingale Agency,E-Commerce,Space Wars,62995322,136163,45382,90781,2022-10-21
2513,The Martingale Agency,Media Supported Asset,Transmorphers,46495636,136077,48219,87858,2022-11-23
2814,Disney Studios,Brand Asset Development,Clay-Dough,63807824,136067,58830,77237,2022-11-29
2138,Nintendo Technologies,Influencer,Transmorphers,42627533,135993,22590,113403,2022-11-23
2537,KYG Antler LLC,Brand Asset Development,Transmorphers,47826049,135907,72644,63263,2022-10-30
1302,Disney Studios,E-Commerce,Merf,24617166,135692,83557,52135,2022-10-24
2751,The Martingale Agency,Media Supported Asset,Merf,33200469,135575,2161,133414,2022-11-14
3840,Pinterest Inc,Media Supported Asset,Merf,62602265,135562,6876,128686,2022-10-04
117,The Martingale Agency,Brand Publicity,GI-Bro,40182699,135504,52464,83040,2022-11-16
2699,Pinterest Inc,E-Commerce,Transmorphers,85809946,135436,73795,61641,2022-10-01
883,Meta Platforms,E-Commerce,GI-Bro,75776197,135417,65891,69526,2022-10-30
2181,Meta Platforms,Media Supported Asset,Clay-Dough,60330343,135373,83058,52315,2022-12-01
4528,Pinterest Inc,Brand Asset Development,Space Wars,29132436,135358,74255,61103,2022-12-16
4559,Disney Studios,Brand Asset Development,GI-Bro,91130801,135355,30693,104662,2022-10-17
4230,Meta Platforms,Media Supported Asset,Transmorphers,13587727,135349,27144,108205,2022-11-23
2595,TikTok Inc,Media Supported Asset,GI-Bro,39436762,135161,63739,71422,2022-10-04
1000,Nintendo Technologies,Media Supported Asset,Merf,67971003,134991,55527,79464,2022-11-29
1080,Pinterest Inc,Media Supported Asset,GI-Bro,67876675,134968,10549,124419,2022-12-12
2307,Google Inc.,E-Commerce,Merf,14290603,134897,45816,89081,2022-12-01
539,KYG Antler LLC,E-Commerce,GI-Bro,62321813,134784,73585,61199,2022-12-09
3110,KYG Antler LLC,E-Commerce,GI-Bro,49463016,134650,53975,80675,2022-10-12
4357,Meta Platforms,Brand Asset Development,Clay-Dough,63155699,134623,79910,54713,2022-11-02
3292,Disney Studios,E-Commerce,Merf,15729700,134497,23524,110973,2022-10-19
930,Google Inc.,Brand Asset Development,GI-Bro,86442187,134459,6463,127996,2022-10-20
2482,Pinterest Inc,Influencer,GI-Bro,92692599,134451,76319,58132,2022-11-05
98,Meta Platforms,Brand Asset Development,GI-Bro,14134399,134448,3727,130721,2022-10-29
3875,TikTok Inc,E-Commerce,Clay-Dough,26400632,134371,66290,68081,2022-12-15
4869,Pinterest Inc,Brand Asset Development,Merf,95965958,134336,67658,66678,2022-11-27
4176,Google Inc.,Brand Publicity,Transmorphers,29950733,134322,71287,63035,2022-11-26
2788,TikTok Inc,Brand Publicity,Transmorphers,75583090,134319,31282,103037,2022-11-06
4000,The Martingale Agency,Influencer,Clay-Dough,19147763,134304,20810,113494,2022-11-09
3577,Google Inc.,Media Supported Asset,Transmorphers,72074328,134266,9443,124823,2022-11-05
4286,Disney Studios,Influencer,GI-Bro,93139240,134193,9823,124370,2022-10-24
541,KYG Antler LLC,Influencer,Transmorphers,39967238,134057,25084,108973,2022-10-10
4589,Google Inc.,Media Supported Asset,Clay-Dough,54746198,134040,57977,76063,2022-12-29
2680,Pinterest Inc,Brand Publicity,Transmorphers,12793637,133830,51675,82155,2022-12-20
4041,Google Inc.,E-Commerce,Transmorphers,72844977,133618,50412,83206,2022-10-14
3099,Disney Studios,E-Commerce,Space Wars,32089503,133493,14179,119314,2022-11-06
2958,Pinterest Inc,Influencer,GI-Bro,68803952,133453,11846,121607,2022-12-05
672,Google Inc.,Influencer,Merf,34842294,133219,26931,106288,2022-12-05
1045,TikTok Inc,Influencer,Transmorphers,70525055,133161,45453,87708,2022-10-11
4628,The Martingale Agency,Brand Asset Development,Transmorphers,97231429,133105,10614,122491,2022-11-17
3792,Google Inc.,Media Supported Asset,GI-Bro,67915752,133055,22411,110644,2022-12-29
3454,Nintendo Technologies,Brand Publicity,Clay-Dough,54244827,133042,77691,55351,2022-11-05
3982,Meta Platforms,Influencer,Clay-Dough,49079290,133008,1793,131215,2022-12-27
4371,Disney Studios,Media Supported Asset,Space Wars,99114454,132970,38262,94708,2022-10-15
3341,Pinterest Inc,Influencer,Clay-Dough,52473785,132948,50584,82364,2022-11-15
3142,Pinterest Inc,Brand Asset Development,Space Wars,60780211,132799,67292,65507,2022-10-23
313,Disney Studios,Media Supported Asset,Space Wars,96560787,132782,20509,112273,2022-12-27
1560,The Martingale Agency,Brand Publicity,Space Wars,96535691,132700,16949,115751,2022-11-17
4100,Google Inc.,E-Commerce,GI-Bro,91580637,132639,61896,70743,2022-12-01
2344,Nintendo Technologies,E-Commerce,Clay-Dough,38209297,132538,69299,63239,2022-11-07
3728,Nintendo Technologies,E-Commerce,Space Wars,46897700,132461,72236,60225,2022-12-20
4240,TikTok Inc,Brand Publicity,Space Wars,60238000,132243,11934,120309,2022-11-14
2996,KYG Antler LLC,Media Supported Asset,Space Wars,77939460,132208,42441,89767,2022-10-26
3965,KYG Antler LLC,Influencer,Merf,10725886,132202,76470,55732,2022-10-13
3746,KYG Antler LLC,E-Commerce,Merf,71106082,132192,14275,117917,2022-10-18
3264,KYG Antler LLC,Influencer,Space Wars,21610402,132173,3081,129092,2022-12-14
3354,KYG Antler LLC,Media Supported Asset,Clay-Dough,10272842,132116,27577,104539,2022-11-26
211,TikTok Inc,Influencer,GI-Bro,83690857,131947,51054,80893,2022-10-22
2960,TikTok Inc,Influencer,Transmorphers,15239785,131926,57729,74197,2022-12-02
80,Meta Platforms,Brand Publicity,Clay-Dough,57254829,131879,42155,89724,2022-10-13
2278,Disney Studios,E-Commerce,Space Wars,23177235,131588,21355,110233,2022-12-27
727,The Martingale Agency,Brand Publicity,Merf,17683273,131512,26971,104541,2022-10-06
1820,Google Inc.,E-Commerce,Merf,36973358,131476,63175,68301,2022-12-05
678,Disney Studios,Influencer,GI-Bro,77519629,131417,35704,95713,2022-10-30
3760,Pinterest Inc,Brand Publicity,Merf,25049435,131170,12415,118755,2022-11-29
2953,Meta Platforms,Brand Publicity,Clay-Dough,84261732,131152,67300,63852,2022-12-28
4211,KYG Antler LLC,Influencer,Space Wars,69501354,131152,72347,58805,2022-10-15
4841,Nintendo Technologies,Media Supported Asset,Clay-Dough,39742007,131145,10335,120810,2022-10-21
731,Google Inc.,Influencer,Transmorphers,22477802,131115,63235,67880,2022-11-02
3130,Disney Studios,Brand Asset Development,Merf,90859044,130944,23402,107542,2022-12-04
865,Google Inc.,Brand Asset Development,Space Wars,72410934,130874,10130,120744,2022-10-25
236,Meta Platforms,Influencer,Merf,61145005,130792,30584,100208,2022-10-14
3062,TikTok Inc,E-Commerce,Merf,52047797,130788,63429,67359,2022-11-30
2459,Nintendo Technologies,Brand Publicity,Space Wars,50736787,130786,10526,120260,2022-11-08
1371,Google Inc.,Brand Asset Development,Clay-Dough,68315958,130784,62196,68588,2022-11-24
3641,Nintendo Technologies,Influencer,Space Wars,48714532,130659,15288,115371,2022-11-02
1072,Google Inc.,Brand Publicity,Transmorphers,17738475,130641,9394,121247,2022-10-03
4133,Disney Studios,Media Supported Asset,Merf,75630721,130631,64927,65704,2022-10-30
2173,Meta Platforms,Influencer,Clay-Dough,15465431,130293,55934,74359,2022-11-16
4465,Disney Studios,Influencer,Clay-Dough,32489201,130226,172,130054,2022-10-20
4513,Disney Studios,E-Commerce,Space Wars,17475963,130218,46192,84026,2022-12-29
22,The Martingale Agency,Brand Asset Development,Space Wars,60153605,130205,53167,77038,2022-10-13
2411,Meta Platforms,Brand Publicity,GI-Bro,21266804,129945,51450,78495,2022-10-17
1164,KYG Antler LLC,Influencer,Space Wars,48179262,129731,6909,122822,2022-11-17
3548,The Martingale Agency,Brand Asset Development,Transmorphers,99422167,129718,17771,111947,2022-11-28
1444,Disney Studios,Influencer,Merf,35848308,129712,2404,127308,2022-10-28
2288,Pinterest Inc,Media Supported Asset,Transmorphers,60081332,129598,17154,112444,2022-11-08
2440,Disney Studios,Media Supported Asset,Transmorphers,62297047,129500,54139,75361,2022-11-18
709,KYG Antler LLC,Influencer,Merf,84905762,129251,1642,127609,2022-11-04
1685,TikTok Inc,Influencer,GI-Bro,33234967,129109,58781,70328,2022-12-04
980,Google Inc.,Influencer,Transmorphers,56894100,129099,14943,114156,2022-12-18
2326,Google Inc.,Brand Publicity,GI-Bro,92446241,129034,65817,63217,2022-10-31
1988,Google Inc.,Influencer,Merf,73767061,128987,70933,58054,2022-10-05
2358,Meta Platforms,Brand Publicity,Space Wars,67589938,128957,22045,106912,2022-12-29
312,KYG Antler LLC,E-Commerce,GI-Bro,70843447,128823,13836,114987,2022-11-17
194,Meta Platforms,Brand Asset Development,Transmorphers,93434504,128648,78077,50571,2022-10-13
4941,Nintendo Technologies,Influencer,Space Wars,55920523,128638,67072,61566,2022-12-08
323,KYG Antler LLC,Influencer,Merf,25995282,128614,78465,50149,2022-12-11
26,The Martingale Agency,Brand Asset Development,Transmorphers,60758548,128442,37112,91330,2022-11-22
4223,Pinterest Inc,Influencer,Merf,86019549,128420,61310,67110,2022-12-11
2780,Pinterest Inc,Brand Publicity,Space Wars,63265974,128398,53821,74577,2022-11-12
4023,Google Inc.,Brand Asset Development,Transmorphers,39462626,128392,26579,101813,2022-10-05
2571,The Martingale Agency,Influencer,Transmorphers,46038026,128366,50576,77790,2022-12-22
1964,Google Inc.,Influencer,Space Wars,34195553,128361,62233,66128,2022-12-23
1017,Google Inc.,Brand Publicity,Transmorphers,15215227,128316,57268,71048,2022-12-26
460,Nintendo Technologies,Influencer,Clay-Dough,58966619,128128,50943,77185,2022-12-13
3578,Nintendo Technologies,Media Supported Asset,Transmorphers,74877515,127936,77613,50323,2022-12-24
1667,Pinterest Inc,Brand Asset Development,Transmorphers,47866003,127670,17858,109812,2022-11-13
259,TikTok Inc,Media Supported Asset,Merf,50326731,127649,58331,69318,2022-12-14
2820,Pinterest Inc,Influencer,Space Wars,99799801,127608,38678,88930,2022-11-14
1872,Nintendo Technologies,Influencer,Space Wars,41528433,127582,13179,114403,2022-11-20
545,The Martingale Agency,Brand Asset Development,Transmorphers,60692999,127404,34606,92798,2022-11-29
4736,KYG Antler LLC,Influencer,Merf,77093560,127366,59150,68216,2022-11-26
1361,Nintendo Technologies,Influencer,Transmorphers,16117726,127276,66655,60621,2022-10-09
690,Nintendo Technologies,Influencer,Clay-Dough,46665188,127232,45419,81813,2022-12-09
4810,Pinterest Inc,Influencer,Clay-Dough,66723361,127140,51631,75509,2022-11-22
4848,Meta Platforms,Brand Asset Development,Clay-Dough,12149640,127137,42682,84455,2022-10-11
3138,Disney Studios,E-Commerce,Transmorphers,90168002,127115,41218,85897,2022-11-02
2135,Disney Studios,Influencer,Transmorphers,52934931,127100,69768,57332,2022-10-24
137,Nintendo Technologies,Media Supported Asset,Space Wars,62563796,126944,70277,56667,2022-11-05
3675,KYG Antler LLC,Brand Asset Development,GI-Bro,68518297,126935,25512,101423,2022-12-16
1023,Disney Studios,Brand Asset Development,Transmorphers,76091750,126893,27565,99328,2022-11-21
4711,Pinterest Inc,Brand Asset Development,GI-Bro,27012053,126883,76060,50823,2022-10-27
151,Meta Platforms,Media Supported Asset,Clay-Dough,73817401,126771,6659,120112,2022-10-03
1034,The Martingale Agency,E-Commerce,Transmorphers,64952937,126546,21323,105223,2022-12-18
3383,TikTok Inc,E-Commerce,Space Wars,67362528,126535,35265,91270,2022-11-28
3789,The Martingale Agency,Media Supported Asset,Clay-Dough,92543385,126414,12408,114006,2022-12-10
3539,Meta Platforms,Media Supported Asset,Clay-Dough,57121210,126380,39769,86611,2022-11-04
1561,KYG Antler LLC,Brand Asset Development,Transmorphers,26649226,126380,20545,105835,2022-11-18
4,KYG Antler LLC,Influencer,Clay-Dough,89754537,126379,46344,80035,2022-12-15
2541,Google Inc.,Influencer,Transmorphers,79738203,126341,42482,83859,2022-12-16
4866,Google Inc.,Brand Asset Development,Space Wars,53406281,126290,33739,92551,2022-11-19
4414,KYG Antler LLC,Brand Publicity,GI-Bro,22099816,126263,55581,70682,2022-12-21
1530,TikTok Inc,Brand Publicity,GI-Bro,29889018,126177,38676,87501,2022-12-23
3545,Nintendo Technologies,Influencer,GI-Bro,36704366,126028,70517,55511,2022-11-08
4434,Disney Studios,Influencer,Transmorphers,43017595,125981,33283,92698,2022-10-08
1343,KYG Antler LLC,E-Commerce,Merf,98905932,125926,7194,118732,2022-12-04
2202,Nintendo Technologies,Influencer,Clay-Dough,53962088,125728,37868,87860,2022-10-23
416,Disney Studios,Brand Asset Development,Clay-Dough,57100828,125577,9669,115908,2022-10-06
2636,The Martingale Agency,Brand Publicity,Merf,16801296,125529,29303,96226,2022-12-13
4143,Google Inc.,Influencer,Space Wars,53385650,125362,43194,82168,2022-10-23
1919,Meta Platforms,Influencer,Space Wars,63401812,125279,74046,51233,2022-10-24
4384,Disney Studios,Brand Asset Development,Clay-Dough,33241316,125139,73289,51850,2022-10-15
2367,The Martingale Agency,Influencer,Clay-Dough,60316122,125053,44039,81014,2022-12-10
546,Meta Platforms,Media Supported Asset,Transmorphers,53511233,124984,11503,113481,2022-07-06
1087,The Martingale Agency,Brand Asset Development,GI-Bro,28895476,124918,18601,106317,2022-10-01
3117,Pinterest Inc,Influencer,Space Wars,47557663,124889,92753,32136,2022-09-12
3617,The Martingale Agency,Brand Asset Development,GI-Bro,69679721,124877,65547,59330,2022-11-06
1552,Disney Studios,E-Commerce,Clay-Dough,60787393,124857,15860,108997,2022-12-28
4202,Meta Platforms,Brand Asset Development,GI-Bro,84931214,124839,23514,101325,2022-11-23
685,Disney Studios,Brand Asset Development,Clay-Dough,49819285,124793,29984,94809,2022-09-05
2160,Pinterest Inc,Brand Publicity,Merf,70155879,124752,24929,99823,2022-08-15
2136,Nintendo Technologies,Influencer,Transmorphers,24076473,124745,61073,63672,2022-12-23
543,KYG Antler LLC,E-Commerce,Space Wars,15043422,124677,67827,56850,2022-11-07
138,Nintendo Technologies,E-Commerce,Merf,88586666,124617,24588,100029,2022-10-09
2864,Pinterest Inc,Media Supported Asset,Transmorphers,40144548,124574,52915,71659,2022-10-16
2706,Google Inc.,E-Commerce,Transmorphers,43142354,124543,6068,118475,2022-08-10
1878,TikTok Inc,E-Commerce,Transmorphers,31891921,124465,57210,67255,2022-11-06
1782,Nintendo Technologies,E-Commerce,Clay-Dough,32959634,124440,55342,69098,2022-11-15
532,Disney Studios,Brand Publicity,GI-Bro,87515797,124359,11620,112739,2022-11-24
967,Google Inc.,Brand Asset Development,GI-Bro,48042110,124339,93346,30993,2022-09-07
1649,Google Inc.,Brand Asset Development,Merf,45848073,124320,59321,64999,2022-12-29
2724,Meta Platforms,Brand Publicity,Space Wars,24322114,124299,50442,73857,2022-08-24
4502,Pinterest Inc,Brand Publicity,Transmorphers,89479597,124286,1222,123064,2022-08-18
4509,TikTok Inc,Brand Asset Development,Merf,44060695,124226,55127,69099,2022-07-17
4843,Nintendo Technologies,E-Commerce,Clay-Dough,46744029,124116,39163,84953,2022-07-04
1742,Disney Studios,Brand Publicity,Transmorphers,68303478,123976,48040,75936,2022-11-08
782,Nintendo Technologies,Brand Asset Development,GI-Bro,88837425,123946,50889,73057,2022-10-19
2140,Pinterest Inc,E-Commerce,GI-Bro,59515733,123926,38278,85648,2022-08-22
1751,Nintendo Technologies,Influencer,Clay-Dough,12798051,123851,11084,112767,2022-10-29
4092,Pinterest Inc,Media Supported Asset,Space Wars,92541400,123849,59325,64524,2022-08-09
3705,Disney Studios,Brand Asset Development,Transmorphers,57763691,123742,74879,48863,2022-08-06
308,The Martingale Agency,Brand Publicity,Clay-Dough,34993690,123713,24291,99422,2022-08-16
1341,Disney Studios,Media Supported Asset,Merf,58140999,123712,34279,89433,2022-11-08
3397,Meta Platforms,Brand Asset Development,GI-Bro,10889902,123642,52067,71575,2022-08-19
2551,Meta Platforms,Influencer,Space Wars,51676500,123635,48897,74738,2022-11-11
464,Google Inc.,Brand Asset Development,GI-Bro,98530653,123612,63492,60120,2022-12-07
3481,Pinterest Inc,E-Commerce,Space Wars,71519574,123575,47125,76450,2022-11-03
132,Nintendo Technologies,Brand Publicity,Merf,39936224,123557,32457,91100,2022-07-05
3636,Google Inc.,E-Commerce,Clay-Dough,44071481,123534,49597,73937,2022-10-06
2038,Pinterest Inc,E-Commerce,Merf,93508297,123509,2299,121210,2022-07-10
1037,Pinterest Inc,Brand Publicity,Transmorphers,74939300,123474,33388,90086,2022-10-23
808,KYG Antler LLC,Brand Asset Development,Clay-Dough,27955564,123445,45122,78323,2022-09-19
1838,Google Inc.,Influencer,Transmorphers,36881578,123256,53701,69555,2022-12-28
2384,Disney Studios,Brand Asset Development,GI-Bro,95284400,123254,3185,120069,2022-10-04
794,Meta Platforms,Media Supported Asset,GI-Bro,50455565,123252,45011,78241,2022-12-01
2951,Disney Studios,Influencer,Space Wars,61521919,123251,36297,86954,2022-07-04
18,The Martingale Agency,E-Commerce,Clay-Dough,95304250,123225,45636,77589,2022-11-11
3680,Nintendo Technologies,Brand Asset Development,Merf,46669169,123210,61200,62010,2022-08-11
3439,Meta Platforms,E-Commerce,Transmorphers,37500650,123204,50917,72287,2022-10-10
1705,Nintendo Technologies,E-Commerce,Transmorphers,86721217,123190,92598,30592,2022-07-11
1709,Google Inc.,Influencer,Space Wars,41519212,123110,6872,116238,2022-08-14
2588,Pinterest Inc,Media Supported Asset,Space Wars,96750387,123092,21830,101262,2022-10-16
3662,Meta Platforms,E-Commerce,Merf,33524063,123060,93860,29200,2022-08-02
3659,Nintendo Technologies,E-Commerce,Merf,35363234,123047,15396,107651,2022-09-28
4325,The Martingale Agency,Media Supported Asset,GI-Bro,56841276,123010,51597,71413,2022-07-29
2543,Meta Platforms,E-Commerce,Transmorphers,98021165,122980,32616,90364,2022-08-29
1729,Nintendo Technologies,Brand Asset Development,GI-Bro,42517907,122977,74493,48484,2022-08-07
2390,Meta Platforms,Brand Publicity,Merf,96267913,122971,70162,52809,2022-08-09
2303,TikTok Inc,Brand Asset Development,Transmorphers,33679345,122936,75621,47315,2022-07-05
2427,The Martingale Agency,Media Supported Asset,Merf,27958586,122899,9771,113128,2022-10-19
4987,Disney Studios,E-Commerce,Merf,23423958,122871,13572,109299,2022-08-03
3042,Nintendo Technologies,Brand Publicity,Merf,94655949,122865,1712,121153,2022-08-11
542,Pinterest Inc,Brand Asset Development,Transmorphers,92454960,122807,73192,49615,2022-08-06
2392,KYG Antler LLC,Brand Asset Development,GI-Bro,13158545,122786,72201,50585,2022-08-01
4127,Meta Platforms,Brand Asset Development,GI-Bro,67092424,122751,64900,57851,2022-07-22
3476,Pinterest Inc,Brand Publicity,Transmorphers,46321625,122706,38304,84402,2022-09-30
2017,Nintendo Technologies,Brand Publicity,Transmorphers,10486563,122639,17708,104931,2022-11-03
4108,Meta Platforms,Brand Publicity,Transmorphers,75853534,122616,28695,93921,2022-09-11
2040,TikTok Inc,E-Commerce,Clay-Dough,39820385,122606,53082,69524,2022-08-04
3552,TikTok Inc,Media Supported Asset,Clay-Dough,54859179,122582,21464,101118,2022-12-20
1195,TikTok Inc,Media Supported Asset,Clay-Dough,26662968,122533,66009,56524,2022-10-31
4383,TikTok Inc,Influencer,Space Wars,83376161,122472,45951,76521,2022-07-08
3678,The Martingale Agency,E-Commerce,Space Wars,17025728,122459,18803,103656,2022-09-29
3031,Google Inc.,Media Supported Asset,Merf,51941029,122290,71925,50365,2022-11-28
4535,TikTok Inc,Brand Asset Development,Transmorphers,24034048,122283,94557,27726,2022-08-27
3971,Nintendo Technologies,Media Supported Asset,Merf,46405438,122162,58254,63908,2022-12-12
3549,TikTok Inc,Brand Asset Development,Merf,61867822,122135,56228,65907,2022-09-13
2311,Meta Platforms,Brand Asset Development,GI-Bro,71846072,122108,90461,31647,2022-08-14
285,TikTok Inc,Media Supported Asset,Clay-Dough,73939135,122028,27169,94859,2022-11-30
447,Nintendo Technologies,Media Supported Asset,Space Wars,33076893,122024,65547,56477,2022-11-25
1105,Google Inc.,Media Supported Asset,Transmorphers,45790312,122015,28530,93485,2022-09-10
4679,Meta Platforms,Influencer,Space Wars,34499789,122004,27010,94994,2022-10-02
2550,The Martingale Agency,Media Supported Asset,Space Wars,52889924,122002,30445,91557,2022-09-12
2714,The Martingale Agency,Brand Publicity,Transmorphers,32570496,121978,14131,107847,2022-08-30
4308,TikTok Inc,E-Commerce,Clay-Dough,15648142,121931,41802,80129,2022-09-24
4624,Meta Platforms,Brand Asset Development,GI-Bro,22610057,121855,22972,98883,2022-11-03
288,KYG Antler LLC,E-Commerce,Clay-Dough,51686332,121718,96279,25439,2022-08-03
2261,KYG Antler LLC,Brand Publicity,Merf,67277301,121701,74480,47221,2022-09-18
289,Disney Studios,Media Supported Asset,Merf,34763555,121682,82747,38935,2022-08-11
3404,Google Inc.,Media Supported Asset,Transmorphers,86805653,121586,12816,108770,2022-11-21
4271,The Martingale Agency,Media Supported Asset,Space Wars,82432069,121562,60067,61495,2022-12-03
973,The Martingale Agency,Influencer,Merf,73103326,121531,75523,46008,2022-09-17
3150,The Martingale Agency,Brand Publicity,Space Wars,36256990,121482,4422,117060,2022-10-22
499,Nintendo Technologies,Influencer,Transmorphers,68608771,121479,64008,57471,2022-11-06
2564,Google Inc.,Media Supported Asset,Transmorphers,92505103,121451,52558,68893,2022-10-20
1118,Google Inc.,Brand Asset Development,GI-Bro,17072273,121423,7649,113774,2022-08-17
2880,Meta Platforms,E-Commerce,Merf,68209787,121404,29306,92098,2022-07-30
3293,Nintendo Technologies,Brand Publicity,Clay-Dough,15635182,121347,45691,75656,2022-08-29
317,TikTok Inc,Media Supported Asset,Transmorphers,53050109,121311,38541,82770,2022-09-07
4578,Google Inc.,Influencer,Clay-Dough,65350108,121304,12279,109025,2022-10-14
4245,Nintendo Technologies,Media Supported Asset,Space Wars,64253623,121145,29084,92061,2022-12-12
1763,Google Inc.,Brand Publicity,Space Wars,27627558,121119,28318,92801,2022-10-28
4724,The Martingale Agency,Media Supported Asset,Merf,93070140,121115,38239,82876,2022-12-20
198,TikTok Inc,E-Commerce,Space Wars,73068437,121100,70467,50633,2022-11-03
868,Nintendo Technologies,Media Supported Asset,GI-Bro,70975877,120993,11297,109696,2022-07-17
2070,Disney Studios,Brand Publicity,Transmorphers,81179783,120971,46611,74360,2022-11-02
4372,Meta Platforms,Brand Asset Development,Merf,98996198,120935,89355,31580,2022-08-04
434,Disney Studios,Influencer,Space Wars,28291258,120847,69088,51759,2022-08-20
587,Disney Studios,Influencer,Space Wars,22057712,120785,65387,55398,2022-12-10
2712,Nintendo Technologies,Brand Asset Development,Merf,61785279,120714,79419,41295,2022-07-09
4556,Meta Platforms,Brand Asset Development,Merf,40901189,120664,51013,69651,2022-12-03
3973,Google Inc.,E-Commerce,Space Wars,45300559,120608,37223,83385,2022-12-04
4338,The Martingale Agency,Brand Asset Development,Transmorphers,34856969,120516,55116,65400,2022-10-30
890,KYG Antler LLC,Media Supported Asset,Transmorphers,85610364,120508,79456,41052,2022-07-06
2885,Nintendo Technologies,Brand Publicity,Space Wars,41293774,120505,19692,100813,2022-10-23
1706,Nintendo Technologies,Influencer,Merf,77628002,120488,45932,74556,2022-12-28
3362,TikTok Inc,Brand Publicity,Transmorphers,73414413,120412,59028,61384,2022-08-12
377,Google Inc.,Brand Publicity,Transmorphers,45036890,120400,34066,86334,2022-12-16
2309,The Martingale Agency,Media Supported Asset,Space Wars,73674652,120290,839,119451,2022-12-24
3147,Pinterest Inc,Influencer,Clay-Dough,26096618,120271,76113,44158,2022-08-24
1413,KYG Antler LLC,Media Supported Asset,Merf,51633753,120252,72633,47619,2022-07-12
2653,Google Inc.,Media Supported Asset,GI-Bro,70037271,120250,19461,100789,2022-12-19
2578,Pinterest Inc,Influencer,Clay-Dough,11675553,120235,61495,58740,2022-09-21
3635,Meta Platforms,E-Commerce,Merf,17868069,120157,10032,110125,2022-12-11
4847,The Martingale Agency,E-Commerce,Space Wars,63977163,120109,69416,50693,2022-07-13
1060,The Martingale Agency,Brand Publicity,Merf,38934430,120095,37269,82826,2022-09-29
1590,Meta Platforms,Brand Asset Development,GI-Bro,68329058,120082,54330,65752,2022-07-18
548,TikTok Inc,Media Supported Asset,Merf,91680124,119957,46398,73559,2022-09-01
3114,Google Inc.,E-Commerce,GI-Bro,45821707,119936,13482,106454,2022-10-27
4855,The Martingale Agency,Media Supported Asset,Space Wars,59841101,119924,50277,69647,2022-07-10
902,Google Inc.,Media Supported Asset,GI-Bro,18968071,119909,94887,25022,2022-08-17
3128,The Martingale Agency,Media Supported Asset,Merf,38516987,119897,53096,66801,2022-10-23
1719,Google Inc.,Influencer,Transmorphers,11762182,119852,38512,81340,2022-12-28
2832,Pinterest Inc,Brand Asset Development,Clay-Dough,78578411,119835,13417,106418,2022-11-15
2606,KYG Antler LLC,Media Supported Asset,GI-Bro,82194647,119832,52210,67622,2022-08-06
802,KYG Antler LLC,Influencer,Space Wars,54973392,119707,12815,106892,2022-12-03
533,Google Inc.,Brand Asset Development,Clay-Dough,54098934,119688,45542,74146,2022-10-25
2849,Meta Platforms,E-Commerce,GI-Bro,64463908,119657,71211,48446,2022-09-10
2665,KYG Antler LLC,Media Supported Asset,Transmorphers,81968926,119653,28549,91104,2022-08-16
1001,Meta Platforms,E-Commerce,GI-Bro,20154032,119582,20117,99465,2022-09-04
1456,TikTok Inc,E-Commerce,Space Wars,30706172,119574,69609,49965,2022-07-22
2950,Pinterest Inc,Brand Asset Development,Clay-Dough,46963773,119549,12074,107475,2022-12-13
3642,The Martingale Agency,Brand Asset Development,Transmorphers,46553111,119526,40603,78923,2022-11-26
3899,Google Inc.,E-Commerce,Space Wars,21163874,119516,59271,60245,2022-10-05
128,KYG Antler LLC,Brand Publicity,Space Wars,79020011,119496,1743,117753,2022-10-31
1334,Nintendo Technologies,Brand Asset Development,Clay-Dough,88394559,119395,68905,50490,2022-12-01
831,TikTok Inc,E-Commerce,Transmorphers,54578098,119379,76148,43231,2022-07-12
4725,Pinterest Inc,Brand Publicity,GI-Bro,34015421,119339,15985,103354,2022-11-06
4293,Nintendo Technologies,Influencer,Space Wars,25092424,119324,3001,116323,2022-10-13
1470,The Martingale Agency,E-Commerce,GI-Bro,12184015,119320,13446,105874,2022-11-11
2771,Meta Platforms,E-Commerce,Clay-Dough,84697905,119229,47134,72095,2022-12-28
1283,Google Inc.,Brand Asset Development,Merf,79996620,119092,19248,99844,2022-07-23
553,Nintendo Technologies,Media Supported Asset,GI-Bro,34479321,119090,24829,94261,2022-11-04
4376,Google Inc.,Media Supported Asset,GI-Bro,77590386,119080,41386,77694,2022-12-22
1743,Meta Platforms,Media Supported Asset,Transmorphers,16587746,119044,58276,60768,2022-09-09
429,TikTok Inc,Influencer,Clay-Dough,73021425,118981,56656,62325,2022-10-29
3343,Disney Studios,Brand Publicity,Clay-Dough,53574201,118949,26659,92290,2022-11-22
2631,Disney Studios,Brand Asset Development,Space Wars,74420134,118817,8868,109949,2022-07-20
2306,Nintendo Technologies,Influencer,Transmorphers,74242771,118750,67350,51400,2022-12-18
3048,TikTok Inc,Brand Asset Development,Space Wars,49389317,118743,3090,115653,2022-11-01
2476,Disney Studios,Media Supported Asset,Space Wars,73408676,118684,51733,66951,2022-10-02
1353,KYG Antler LLC,Influencer,Transmorphers,15959302,118670,60173,58497,2022-11-01
2773,Meta Platforms,Influencer,Merf,45808256,118654,42886,75768,2022-10-02
550,The Martingale Agency,Media Supported Asset,Clay-Dough,39354225,118617,3541,115076,2022-08-20
2318,TikTok Inc,E-Commerce,Merf,64076877,118582,29426,89156,2022-09-23
1053,Nintendo Technologies,Media Supported Asset,Merf,34874053,118570,77431,41139,2022-08-14
3778,Disney Studios,Brand Asset Development,Transmorphers,75478205,118462,8080,110382,2022-12-24
1322,Pinterest Inc,E-Commerce,Clay-Dough,45774064,118427,25551,92876,2022-09-20
2938,Meta Platforms,Brand Publicity,Clay-Dough,48843479,118342,15518,102824,2022-12-09
2393,The Martingale Agency,Brand Asset Development,Clay-Dough,20768928,118270,45775,72495,2022-09-13
2856,Pinterest Inc,Influencer,Merf,97308679,118248,17781,100467,2022-08-24
3908,TikTok Inc,Brand Asset Development,Clay-Dough,58770250,118230,63924,54306,2022-08-15
3134,The Martingale Agency,E-Commerce,GI-Bro,63127015,118211,10296,107915,2022-12-09
3589,KYG Antler LLC,E-Commerce,Space Wars,56443472,118195,20509,97686,2022-12-21
4186,The Martingale Agency,Brand Publicity,Space Wars,55808933,118113,78658,39455,2022-09-13
4198,TikTok Inc,Influencer,Merf,31255633,118105,33026,85079,2022-09-13
4412,Nintendo Technologies,Media Supported Asset,Merf,73405872,118079,9152,108927,2022-10-05
3702,Google Inc.,Brand Publicity,Transmorphers,38603274,117987,67843,50144,2022-10-14
3762,Meta Platforms,Brand Asset Development,Space Wars,14912532,117972,72530,45442,2022-09-18
1902,The Martingale Agency,Influencer,GI-Bro,69267953,117956,41744,76212,2022-11-18
3906,Google Inc.,Influencer,Merf,95021002,117954,90072,27882,2022-08-21
4576,Nintendo Technologies,Influencer,Space Wars,69362536,117855,92212,25643,2022-09-28
3349,Google Inc.,Brand Publicity,GI-Bro,59690300,117855,56850,61005,2022-09-09
4005,TikTok Inc,Brand Asset Development,Clay-Dough,38515848,117853,23483,94370,2022-12-24
4671,Disney Studios,Brand Publicity,Space Wars,66313491,117759,3715,114044,2022-12-03
4935,KYG Antler LLC,Influencer,Space Wars,26107237,117754,15096,102658,2022-09-04
4573,KYG Antler LLC,Brand Asset Development,Clay-Dough,12093936,117727,6742,110985,2022-12-11
2443,The Martingale Agency,Influencer,Clay-Dough,20666467,117688,75744,41944,2022-09-19
776,KYG Antler LLC,Influencer,Transmorphers,82539018,117661,42998,74663,2022-11-18
78,Pinterest Inc,Brand Publicity,Clay-Dough,30598742,117629,380,117249,2022-09-07
2095,KYG Antler LLC,Influencer,GI-Bro,49064757,117611,315,117296,2022-10-06
915,Disney Studios,Media Supported Asset,Clay-Dough,92257666,117585,38999,78586,2022-08-06
4356,KYG Antler LLC,Brand Publicity,GI-Bro,70170832,117578,37395,80183,2022-10-21
2291,Pinterest Inc,Brand Publicity,Transmorphers,87712204,117530,2012,115518,2022-08-20
4075,Meta Platforms,E-Commerce,Transmorphers,77344798,117420,61904,55516,2022-07-09
3272,Nintendo Technologies,Brand Asset Development,Transmorphers,78125566,117271,60051,57220,2022-07-17
2580,Pinterest Inc,Media Supported Asset,Transmorphers,28354593,117241,63601,53640,2022-08-28
2762,Pinterest Inc,Media Supported Asset,Transmorphers,19413577,117219,9108,108111,2022-08-21
3753,KYG Antler LLC,Brand Publicity,Merf,36918459,117217,82597,34620,2022-08-22
4209,Disney Studios,Media Supported Asset,Merf,81443044,117196,60492,56704,2022-12-17
4251,TikTok Inc,Influencer,GI-Bro,62622510,117194,28507,88687,2022-07-06
2490,Nintendo Technologies,E-Commerce,Transmorphers,50764072,117168,59705,57463,2022-08-13
3854,The Martingale Agency,Influencer,Space Wars,75878109,117008,21242,95766,2022-07-19
4272,Meta Platforms,Brand Asset Development,Transmorphers,84312232,116983,64758,52225,2022-11-18
2329,The Martingale Agency,Media Supported Asset,Clay-Dough,86756602,116979,1807,115172,2022-07-26
4070,The Martingale Agency,Media Supported Asset,Merf,67515838,116970,68432,48538,2022-07-16
435,KYG Antler LLC,E-Commerce,Transmorphers,86437437,116891,62820,54071,2022-12-19
4720,Google Inc.,Brand Asset Development,Transmorphers,16194527,116846,80764,36082,2022-09-24
124,TikTok Inc,Influencer,Merf,82289314,116817,65862,50955,2022-12-29
3866,Google Inc.,Influencer,Clay-Dough,75427657,116773,38913,77860,2022-09-23
4492,Nintendo Technologies,E-Commerce,Clay-Dough,28641017,116696,32866,83830,2022-11-29
2710,Disney Studios,E-Commerce,Clay-Dough,71778089,116682,43237,73445,2022-09-06
3947,TikTok Inc,Influencer,Transmorphers,80165301,116679,54438,62241,2022-09-29
2442,TikTok Inc,Brand Asset Development,Space Wars,50965831,116665,84800,31865,2022-08-01
4755,Disney Studios,Brand Asset Development,GI-Bro,74664050,116621,63230,53391,2022-11-20
1477,The Martingale Agency,Brand Publicity,Space Wars,54575136,116597,66265,50332,2022-12-22
238,Google Inc.,Media Supported Asset,GI-Bro,21477655,116469,42240,74229,2022-10-29
1520,TikTok Inc,Brand Asset Development,Clay-Dough,47465980,116467,47436,69031,2022-12-21
3107,Pinterest Inc,E-Commerce,Space Wars,93789470,116462,15684,100778,2022-12-20
1182,KYG Antler LLC,Brand Asset Development,GI-Bro,34224006,116413,21189,95224,2022-07-05
2940,The Martingale Agency,E-Commerce,Transmorphers,38716348,116315,34083,82232,2022-07-20
4398,Google Inc.,Brand Publicity,GI-Bro,70021687,116291,68766,47525,2022-08-20
3139,TikTok Inc,Brand Publicity,Merf,35526831,116281,40605,75676,2022-11-09
1832,The Martingale Agency,Influencer,GI-Bro,73235807,116184,62656,53528,2022-10-08
3694,TikTok Inc,Influencer,GI-Bro,27175757,116162,32776,83386,2022-11-09
4449,Nintendo Technologies,Brand Publicity,Clay-Dough,25061425,116158,35959,80199,2022-09-21
734,Disney Studios,Brand Asset Development,Clay-Dough,34839318,116154,43466,72688,2022-10-19
4088,KYG Antler LLC,Brand Asset Development,GI-Bro,18388196,116052,87309,28743,2022-07-08
4642,Google Inc.,Media Supported Asset,Transmorphers,38934615,116030,40612,75418,2022-10-24
1601,TikTok Inc,Influencer,Merf,39039791,116011,38274,77737,2022-08-11
3060,Pinterest Inc,Brand Asset Development,GI-Bro,99710505,115968,36763,79205,2022-07-12
3934,Nintendo Technologies,Brand Asset Development,Clay-Dough,47023385,115935,6916,109019,2022-08-19
1488,Disney Studios,Influencer,Transmorphers,25973236,115884,53133,62751,2022-10-30
4532,Disney Studios,Brand Asset Development,Transmorphers,58090523,115873,57578,58295,2022-11-26
3127,Pinterest Inc,Media Supported Asset,Transmorphers,49041143,115861,5991,109870,2022-08-29
3506,Nintendo Technologies,Brand Publicity,Transmorphers,65805495,115774,68409,47365,2022-08-23
1083,The Martingale Agency,Media Supported Asset,Transmorphers,85086736,115679,29469,86210,2022-10-05
273,Meta Platforms,Influencer,GI-Bro,50533340,115675,46430,69245,2022-08-19
4472,The Martingale Agency,Media Supported Asset,Space Wars,23241833,115675,58679,56996,2022-10-20
4587,Disney Studios,Influencer,Clay-Dough,24659567,115662,62326,53336,2022-07-10
105,Pinterest Inc,Brand Publicity,Space Wars,19574133,115574,43763,71811,2022-11-06
4704,TikTok Inc,Influencer,Clay-Dough,39344433,115569,88171,27398,2022-08-01
2494,Google Inc.,Brand Asset Development,Transmorphers,87640751,115488,17727,97761,2022-12-03
3676,Disney Studios,E-Commerce,Clay-Dough,51193152,115484,64965,50519,2022-07-03
2128,Disney Studios,Influencer,Merf,48902920,115353,44164,71189,2022-12-08
518,TikTok Inc,Brand Asset Development,Transmorphers,13261141,115328,20450,94878,2022-12-03
4279,Disney Studios,Brand Asset Development,Merf,47071819,115254,17006,98248,2022-11-01
1027,Meta Platforms,Brand Asset Development,GI-Bro,31911101,115204,45167,70037,2022-07-20
3282,Google Inc.,E-Commerce,Clay-Dough,40472234,115157,37121,78036,2022-10-12
606,The Martingale Agency,Influencer,Space Wars,83856795,115125,26756,88369,2022-09-12
3109,Meta Platforms,Media Supported Asset,Clay-Dough,97113601,115091,52511,62580,2022-10-07
2895,Disney Studios,Media Supported Asset,Transmorphers,63989713,115080,78317,36763,2022-09-26
3015,Disney Studios,Media Supported Asset,Clay-Dough,69796506,115057,65380,49677,2022-07-20
3403,The Martingale Agency,Influencer,GI-Bro,78859174,115039,10144,104895,2022-12-29
4751,TikTok Inc,E-Commerce,Merf,23111139,115033,76898,38135,2022-07-25
248,Nintendo Technologies,E-Commerce,Space Wars,21857494,114970,2597,112373,2022-12-14
110,Meta Platforms,Influencer,Clay-Dough,16974143,114965,62279,52686,2022-12-26
300,TikTok Inc,Brand Asset Development,Transmorphers,94096963,114937,18969,95968,2022-08-18
2013,Nintendo Technologies,Media Supported Asset,GI-Bro,29922098,114885,64028,50857,2022-12-24
3388,The Martingale Agency,E-Commerce,Transmorphers,96811162,114870,78975,35895,2022-08-15
3916,Nintendo Technologies,Brand Asset Development,Clay-Dough,24639889,114846,9006,105840,2022-09-03
446,Nintendo Technologies,Influencer,Merf,91250028,114843,51978,62865,2022-12-28
1279,Nintendo Technologies,E-Commerce,Space Wars,86720780,114694,4277,110417,2022-10-12
2597,Disney Studios,E-Commerce,GI-Bro,99168041,114673,189,114484,2022-07-01
4354,Pinterest Inc,Media Supported Asset,Transmorphers,87845922,114669,20827,93842,2022-09-07
594,TikTok Inc,Brand Asset Development,Space Wars,71157943,114645,5920,108725,2022-09-10
1985,The Martingale Agency,Influencer,GI-Bro,15576367,114617,57421,57196,2022-09-03
2223,KYG Antler LLC,Media Supported Asset,Clay-Dough,26289433,114596,31493,83103,2022-12-22
4938,KYG Antler LLC,Brand Asset Development,Clay-Dough,16440928,114573,4729,109844,2022-10-24
2296,TikTok Inc,Brand Publicity,Merf,92302010,114556,33239,81317,2022-12-17
4287,Meta Platforms,Brand Publicity,Transmorphers,78371786,114515,38033,76482,2022-07-26
4111,Disney Studios,Media Supported Asset,Merf,86145014,114437,78354,36083,2022-09-04
3980,Pinterest Inc,Brand Publicity,Clay-Dough,89790998,114427,7093,107334,2022-11-02
2784,Google Inc.,Influencer,Merf,94239171,114401,60665,53736,2022-11-07
4910,Nintendo Technologies,Brand Publicity,Transmorphers,71021337,114374,22393,91981,2022-11-30
1614,Meta Platforms,Media Supported Asset,GI-Bro,64697126,114303,40376,73927,2022-10-17
600,Disney Studios,Brand Publicity,Space Wars,33697318,114291,56408,57883,2022-11-27
3330,Disney Studios,E-Commerce,Clay-Dough,66171071,114287,28646,85641,2022-10-20
3045,KYG Antler LLC,E-Commerce,Merf,18715204,114260,6248,108012,2022-10-14
443,Nintendo Technologies,Influencer,GI-Bro,13773963,114255,56917,57338,2022-07-05
2194,The Martingale Agency,E-Commerce,Clay-Dough,77703041,114204,49153,65051,2022-10-03
4585,Pinterest Inc,Brand Asset Development,Transmorphers,68404089,114203,38236,75967,2022-10-22
3646,Disney Studios,Media Supported Asset,Merf,58770164,114194,25431,88763,2022-12-14
2460,Disney Studios,Media Supported Asset,Space Wars,18893389,114147,20878,93269,2022-07-22
3822,Pinterest Inc,Brand Publicity,Transmorphers,42356780,114054,3293,110761,2022-11-05
223,KYG Antler LLC,E-Commerce,Clay-Dough,79062463,114033,57479,56554,2022-11-24
4124,Nintendo Technologies,E-Commerce,Space Wars,78793292,113837,6501,107336,2022-11-29
3677,Nintendo Technologies,E-Commerce,Merf,77325167,113822,77503,36319,2022-07-16
4458,The Martingale Agency,Influencer,Space Wars,25063091,113772,302,113470,2022-07-12
2603,TikTok Inc,Influencer,Space Wars,52021945,113729,60516,53213,2022-08-10
2841,TikTok Inc,E-Commerce,Clay-Dough,34404050,113681,43673,70008,2022-12-08
4191,Disney Studios,E-Commerce,Transmorphers,52921941,113673,5411,108262,2022-07-29
3830,Meta Platforms,Brand Publicity,Clay-Dough,89921295,113657,71111,42546,2022-09-05
4966,Nintendo Technologies,E-Commerce,Merf,44557084,113599,20573,93026,2022-08-08
287,Google Inc.,Brand Publicity,GI-Bro,18010502,113559,62459,51100,2022-12-06
1433,Meta Platforms,Brand Asset Development,Transmorphers,79731155,113525,64934,48591,2022-07-09
579,Pinterest Inc,Media Supported Asset,Clay-Dough,84444373,113514,55491,58023,2022-07-27
2386,Disney Studios,Media Supported Asset,Space Wars,57548960,113492,50611,62881,2022-11-13
4034,KYG Antler LLC,Media Supported Asset,Clay-Dough,97734360,113486,47871,65615,2022-09-02
35,Meta Platforms,Influencer,Transmorphers,16831914,113370,52231,61139,2022-07-04
1425,TikTok Inc,E-Commerce,Merf,52672738,113334,23868,89466,2022-10-28
3652,Google Inc.,E-Commerce,Clay-Dough,74597940,113328,32054,81274,2022-08-31
3275,Nintendo Technologies,E-Commerce,Merf,16397350,113284,40425,72859,2022-10-31
3452,Pinterest Inc,Media Supported Asset,Transmorphers,83945027,113261,8607,104654,2022-10-04
2824,Disney Studios,Influencer,Space Wars,21264742,113201,79701,33500,2022-09-13
3115,The Martingale Agency,Influencer,Merf,29504872,113188,36433,76755,2022-12-25
529,TikTok Inc,Brand Publicity,Space Wars,90594857,113165,23831,89334,2022-09-28
4277,Nintendo Technologies,Brand Asset Development,Space Wars,91414158,113123,52108,61015,2022-07-20
4959,Nintendo Technologies,Brand Publicity,Clay-Dough,94047927,113117,52542,60575,2022-09-21
3852,Meta Platforms,Media Supported Asset,Clay-Dough,78545940,113035,80878,32157,2022-07-31
3106,Nintendo Technologies,Influencer,GI-Bro,60154817,112977,13755,99222,2022-10-24
1482,Nintendo Technologies,E-Commerce,Merf,44753110,112844,5393,107451,2022-12-09
2408,Meta Platforms,Influencer,Merf,22468936,112786,8501,104285,2022-12-25
2304,Google Inc.,Influencer,Space Wars,11024705,112785,52859,59926,2022-08-14
1868,Nintendo Technologies,E-Commerce,Merf,22806101,112781,41099,71682,2022-10-26
3435,TikTok Inc,Brand Publicity,GI-Bro,36317561,112693,732,111961,2022-11-17
4207,Nintendo Technologies,E-Commerce,GI-Bro,36007618,112674,51683,60991,2022-11-26
4253,TikTok Inc,Brand Publicity,Merf,16517412,112631,15163,97468,2022-09-14
2468,Disney Studios,Brand Asset Development,Space Wars,23954557,112620,1996,110624,2022-10-08
1422,Meta Platforms,E-Commerce,Transmorphers,78810529,112607,55183,57424,2022-08-30
821,Disney Studios,Media Supported Asset,Space Wars,14043825,112547,13477,99070,2022-08-03
4943,Nintendo Technologies,Brand Publicity,Space Wars,50781776,112527,17545,94982,2022-09-12
359,The Martingale Agency,Media Supported Asset,Clay-Dough,53877371,112494,22273,90221,2022-09-21
4568,Pinterest Inc,Brand Asset Development,Merf,27885449,112480,61375,51105,2022-07-31
3978,TikTok Inc,E-Commerce,Space Wars,26093935,112469,18135,94334,2022-09-12
3313,Meta Platforms,Brand Asset Development,Transmorphers,10683583,112459,45182,67277,2022-11-13
1481,KYG Antler LLC,Influencer,Clay-Dough,58498887,112359,85054,27305,2022-09-01
3334,Disney Studios,Media Supported Asset,Merf,28638469,112340,12764,99576,2022-09-20
992,Disney Studios,Influencer,Space Wars,27342000,112228,9030,103198,2022-12-11
3422,The Martingale Agency,Brand Asset Development,Transmorphers,98624699,112193,29788,82405,2022-11-25
2133,The Martingale Agency,E-Commerce,Space Wars,35154053,112132,48383,63749,2022-11-17
339,Pinterest Inc,Brand Publicity,Merf,68869201,112117,53475,58642,2022-09-04
2976,Meta Platforms,Brand Publicity,Space Wars,99608694,112104,3673,108431,2022-12-06
1363,TikTok Inc,Brand Publicity,Transmorphers,60171553,112098,77047,35051,2022-09-06
4595,Meta Platforms,Brand Publicity,Space Wars,62153488,112068,46256,65812,2022-08-29
4467,Pinterest Inc,E-Commerce,Clay-Dough,25789368,111969,37354,74615,2022-10-15
725,Nintendo Technologies,Influencer,Clay-Dough,14863891,111910,15450,96460,2022-08-31
366,Disney Studios,Brand Asset Development,Space Wars,31897322,111874,16203,95671,2022-12-25
888,Disney Studios,Media Supported Asset,Transmorphers,87126494,111870,22628,89242,2022-08-14
927,Google Inc.,Influencer,GI-Bro,59204644,111819,21683,90136,2022-11-23
3123,Meta Platforms,Brand Asset Development,Transmorphers,21842444,111814,42853,68961,2022-10-28
2176,Nintendo Technologies,Brand Asset Development,Transmorphers,95352859,111659,18931,92728,2022-11-08
3664,Disney Studios,Media Supported Asset,Space Wars,17223672,111649,31195,80454,2022-11-04
4476,Nintendo Technologies,Brand Asset Development,Merf,48166223,111633,48921,62712,2022-12-05
3877,The Martingale Agency,Brand Asset Development,Space Wars,22650722,111632,28075,83557,2022-09-08
2170,Meta Platforms,Brand Publicity,Transmorphers,24395361,111575,11098,100477,2022-08-21
3305,Meta Platforms,Brand Publicity,GI-Bro,19784286,111564,15062,96502,2022-07-16
3755,Google Inc.,Brand Asset Development,Merf,57321984,111494,36141,75353,2022-10-05
1845,Nintendo Technologies,Influencer,Space Wars,60037846,111419,33263,78156,2022-11-15
3917,The Martingale Agency,Media Supported Asset,GI-Bro,17468102,111369,65481,45888,2022-09-05
879,The Martingale Agency,Brand Asset Development,Clay-Dough,13624781,111356,38317,73039,2022-07-25
1558,Google Inc.,Brand Publicity,Clay-Dough,18437931,111345,82531,28814,2022-09-15
1986,The Martingale Agency,Influencer,Transmorphers,41869946,111264,72002,39262,2022-07-01
4291,KYG Antler LLC,Influencer,GI-Bro,62654389,111191,40424,70767,2022-12-27
355,The Martingale Agency,Brand Asset Development,Merf,87218754,111125,20138,90987,2022-11-04
4678,The Martingale Agency,Influencer,GI-Bro,96872643,111030,18261,92769,2022-08-21
388,Pinterest Inc,Brand Publicity,Clay-Dough,29373186,110868,46903,63965,2022-08-26
4990,Nintendo Technologies,Brand Publicity,Transmorphers,16209090,110842,15401,95441,2022-09-01
2114,Nintendo Technologies,E-Commerce,Clay-Dough,43009060,110799,43663,67136,2022-08-18
3026,Pinterest Inc,E-Commerce,Merf,17129549,110700,20011,90689,2022-12-19
4694,Disney Studios,E-Commerce,Merf,87588434,110683,53124,57559,2022-10-21
2361,The Martingale Agency,E-Commerce,Merf,38228297,110659,15121,95538,2022-10-14
330,Disney Studios,Brand Publicity,GI-Bro,82981414,110623,39833,70790,2022-10-14
4393,Nintendo Technologies,Media Supported Asset,GI-Bro,82825066,110592,2670,107922,2022-12-09
4982,Pinterest Inc,Brand Asset Development,GI-Bro,65738355,110495,14695,95800,2022-10-15
2799,Disney Studios,Brand Publicity,Clay-Dough,92380837,110493,51934,58559,2022-10-06
4452,Pinterest Inc,Media Supported Asset,Transmorphers,40896729,110445,21495,88950,2022-12-03
163,KYG Antler LLC,Brand Asset Development,Clay-Dough,98054450,110415,55145,55270,2022-12-13
4294,The Martingale Agency,Brand Publicity,Space Wars,46644506,110410,72473,37937,2022-08-21
4179,Nintendo Technologies,Media Supported Asset,Clay-Dough,64604221,110378,55291,55087,2022-07-30
4664,Meta Platforms,E-Commerce,Transmorphers,90503601,110377,44574,65803,2022-10-25
3876,Pinterest Inc,E-Commerce,Transmorphers,14390884,110333,47283,63050,2022-12-11
4268,TikTok Inc,Influencer,Merf,57998389,110303,40694,69609,2022-09-20
470,TikTok Inc,Brand Asset Development,GI-Bro,39669234,110246,47353,62893,2022-12-09
3116,KYG Antler LLC,E-Commerce,Space Wars,17260369,110208,54595,55613,2022-07-02
3505,The Martingale Agency,Brand Asset Development,Space Wars,20811536,110157,16427,93730,2022-08-20
114,Google Inc.,Brand Publicity,Clay-Dough,91828869,110102,21040,89062,2022-11-24
4657,Disney Studios,Brand Publicity,Transmorphers,44327733,110041,25023,85018,2022-07-17
4010,The Martingale Agency,Influencer,Merf,94915980,110016,16252,93764,2022-09-23
4598,TikTok Inc,E-Commerce,Space Wars,86739340,110010,9620,100390,2022-11-22
475,Meta Platforms,Influencer,Merf,85697417,110003,50283,59720,2022-09-06
4606,The Martingale Agency,Brand Publicity,Transmorphers,95568395,109964,53893,56071,2022-07-01
3329,Nintendo Technologies,E-Commerce,Transmorphers,62856462,109905,63882,46023,2022-07-22
3640,Pinterest Inc,Media Supported Asset,Space Wars,16688916,109879,10291,99588,2022-11-13
2112,Disney Studios,Media Supported Asset,Transmorphers,53784922,109818,32501,77317,2022-08-31
1957,Pinterest Inc,Brand Publicity,GI-Bro,60597634,109810,42897,66913,2022-09-20
1466,Pinterest Inc,E-Commerce,Merf,22907369,109797,77834,31963,2022-08-08
1821,Google Inc.,E-Commerce,Transmorphers,20257348,109789,55589,54200,2022-12-07
65,KYG Antler LLC,Influencer,GI-Bro,47892391,109765,29011,80754,2022-12-08
898,Pinterest Inc,Brand Publicity,GI-Bro,92404867,109753,20758,88995,2022-12-18
3569,Meta Platforms,Brand Asset Development,Merf,53808389,109690,45045,64645,2022-09-18
761,TikTok Inc,Brand Publicity,Merf,40642174,109684,75913,33771,2022-08-25
310,The Martingale Agency,Media Supported Asset,Transmorphers,68408259,109672,51672,58000,2022-08-06
2377,Disney Studios,Influencer,Space Wars,91637545,109666,14756,94910,2022-07-12
1295,TikTok Inc,Media Supported Asset,Clay-Dough,74495489,109591,7653,101938,2022-09-21
1555,Disney Studios,Influencer,GI-Bro,90489262,109543,7448,102095,2022-12-25
1330,The Martingale Agency,E-Commerce,Transmorphers,56276331,109485,58865,50620,2022-11-20
863,Disney Studios,Brand Publicity,Space Wars,22453989,109481,30344,79137,2022-10-19
3431,Meta Platforms,Brand Publicity,GI-Bro,74447336,109425,52153,57272,2022-11-17
1726,KYG Antler LLC,Brand Publicity,Clay-Dough,52688574,109385,72556,36829,2022-08-08
2705,Nintendo Technologies,Influencer,GI-Bro,64539585,109305,47146,62159,2022-07-30
3411,Pinterest Inc,Brand Publicity,Merf,52799507,109299,21231,88068,2022-07-28
1143,KYG Antler LLC,Brand Asset Development,GI-Bro,28888680,109286,44665,64621,2022-10-27
4069,Pinterest Inc,E-Commerce,Merf,10804687,109263,22853,86410,2022-09-30
4312,KYG Antler LLC,Media Supported Asset,Merf,63649420,109234,27124,82110,2022-11-04
3561,KYG Antler LLC,Brand Publicity,Merf,82827923,109233,51839,57394,2022-07-01
2387,TikTok Inc,E-Commerce,Clay-Dough,32532443,109223,1925,107298,2022-07-01
601,Google Inc.,Brand Asset Development,GI-Bro,39433279,109207,3804,105403,2022-07-13
165,KYG Antler LLC,E-Commerce,Space Wars,94855878,109087,49619,59468,2022-09-22
3169,Nintendo Technologies,Influencer,Clay-Dough,11161824,109040,17547,91493,2022-11-15
4469,The Martingale Agency,Brand Asset Development,Merf,24934505,108951,15470,93481,2022-07-13
619,Meta Platforms,Media Supported Asset,Clay-Dough,58111663,108904,50944,57960,2022-10-07
1663,TikTok Inc,Influencer,GI-Bro,42649024,108795,67772,41023,2022-09-02
752,Pinterest Inc,Influencer,Space Wars,45202674,108783,428,108355,2022-11-18
2439,KYG Antler LLC,Brand Asset Development,Transmorphers,84474623,108776,42412,66364,2022-08-13
4168,Meta Platforms,Influencer,Transmorphers,88938615,108657,56551,52106,2022-08-06
3535,Meta Platforms,Brand Publicity,Clay-Dough,81410365,108641,47036,61605,2022-12-01
352,Meta Platforms,E-Commerce,Clay-Dough,31939275,108610,12251,96359,2022-07-24
3092,Nintendo Technologies,Media Supported Asset,Merf,98670733,108602,51228,57374,2022-09-05
4060,The Martingale Agency,Brand Asset Development,GI-Bro,68865309,108554,65233,43321,2022-07-17
987,KYG Antler LLC,Influencer,Clay-Dough,80906987,108386,48815,59571,2022-08-11
4139,Disney Studios,Brand Publicity,Clay-Dough,69993746,108360,31212,77148,2022-08-07
4659,Meta Platforms,Brand Asset Development,Clay-Dough,52472371,108326,29834,78492,2022-07-09
309,Disney Studios,Media Supported Asset,Clay-Dough,91563450,108314,27811,80503,2022-09-29
1224,Pinterest Inc,Brand Asset Development,Transmorphers,27715797,108306,45449,62857,2022-11-10
4002,Nintendo Technologies,Influencer,Space Wars,30430050,108299,75757,32542,2022-08-22
4564,TikTok Inc,Brand Publicity,Clay-Dough,61166884,108279,2976,105303,2022-11-05
314,Meta Platforms,Brand Asset Development,Clay-Dough,75822297,108273,8236,100037,2022-10-12
4820,Disney Studios,E-Commerce,Clay-Dough,10571965,108270,7481,100789,2022-12-20
2094,Disney Studios,Influencer,Clay-Dough,98910348,108196,23172,85024,2022-11-27
2926,KYG Antler LLC,Brand Publicity,GI-Bro,48772459,108155,28327,79828,2022-08-03
1830,Meta Platforms,Brand Asset Development,Transmorphers,73244730,108043,44858,63185,2022-12-16
4094,TikTok Inc,Influencer,Merf,52051299,107989,56659,51330,2022-07-15
2282,Nintendo Technologies,Brand Asset Development,GI-Bro,25065755,107933,28919,79014,2022-12-13
3085,Disney Studios,Brand Publicity,Clay-Dough,31369021,107836,11374,96462,2022-11-13
877,The Martingale Agency,E-Commerce,Merf,65818072,107741,50615,57126,2022-10-01
2977,Pinterest Inc,Brand Asset Development,GI-Bro,25246763,107703,78587,29116,2022-07-26
3326,TikTok Inc,Brand Asset Development,Merf,81023635,107647,63591,44056,2022-08-28
1953,KYG Antler LLC,Brand Asset Development,Space Wars,87782377,107566,25771,81795,2022-07-03
1498,Google Inc.,E-Commerce,Space Wars,53242267,107557,803,106754,2022-11-01
2866,Meta Platforms,E-Commerce,Transmorphers,32414366,107409,3117,104292,2022-11-12
3165,The Martingale Agency,E-Commerce,Transmorphers,35830389,107321,20913,86408,2022-10-08
623,TikTok Inc,Influencer,Transmorphers,21387198,107316,32752,74564,2022-12-01
1033,Pinterest Inc,E-Commerce,Transmorphers,16558908,107295,53795,53500,2022-09-25
857,Pinterest Inc,Brand Publicity,Space Wars,66000562,107290,11841,95449,2022-07-28
3498,The Martingale Agency,Brand Asset Development,Merf,84399284,107243,55062,52181,2022-10-24
3701,Meta Platforms,Media Supported Asset,Space Wars,67997865,107242,10802,96440,2022-09-07
1688,KYG Antler LLC,E-Commerce,Clay-Dough,18433399,107235,79314,27921,2022-07-09
1304,Meta Platforms,E-Commerce,Merf,91297607,107201,53071,54130,2022-08-06
1235,Meta Platforms,Brand Publicity,Merf,23454629,107178,8639,98539,2022-10-29
3513,KYG Antler LLC,Brand Publicity,Clay-Dough,72600806,107069,12207,94862,2022-08-04
3456,The Martingale Agency,Media Supported Asset,Transmorphers,81914934,107047,23429,83618,2022-12-25
2248,Pinterest Inc,Brand Asset Development,GI-Bro,68389040,107033,64147,42886,2022-07-30
642,The Martingale Agency,Influencer,Clay-Dough,10672145,107010,33350,73660,2022-09-22
4490,Google Inc.,Influencer,GI-Bro,22199470,106974,33573,73401,2022-12-17
908,Disney Studios,Influencer,Transmorphers,30779933,106954,46451,60503,2022-11-23
2920,Google Inc.,Media Supported Asset,GI-Bro,97797489,106932,28516,78416,2022-08-22
3041,TikTok Inc,Influencer,Space Wars,61186296,106931,22677,84254,2022-07-05
4353,Disney Studios,Brand Asset Development,Transmorphers,41710824,106901,16618,90283,2022-12-05
561,Nintendo Technologies,Media Supported Asset,Space Wars,55390376,106853,70242,36611,2022-09-14
3387,Pinterest Inc,Brand Asset Development,Transmorphers,90372152,106848,15583,91265,2022-12-24
4129,KYG Antler LLC,E-Commerce,Clay-Dough,88526687,106831,40941,65890,2022-11-20
2028,The Martingale Agency,Influencer,Transmorphers,42081759,106826,9130,97696,2022-09-29
395,The Martingale Agency,Brand Asset Development,Merf,97698469,106825,36371,70454,2022-10-23
1547,Google Inc.,E-Commerce,Transmorphers,45332668,106714,54977,51737,2022-10-01
3716,The Martingale Agency,Media Supported Asset,Space Wars,43096637,106675,10506,96169,2022-07-23
2430,Nintendo Technologies,Brand Asset Development,Clay-Dough,59108975,106643,56029,50614,2022-11-02
3667,The Martingale Agency,Media Supported Asset,Transmorphers,53472578,106578,39500,67078,2022-09-10
3766,TikTok Inc,Brand Publicity,Clay-Dough,38491328,106553,61104,45449,2022-07-01
4340,Meta Platforms,Brand Asset Development,Merf,41801389,106547,627,105920,2022-12-21
1666,Meta Platforms,Brand Asset Development,Merf,83292993,106547,21868,84679,2022-12-06
4138,TikTok Inc,Media Supported Asset,Merf,74693881,106504,76151,30353,2022-08-04
4824,KYG Antler LLC,Brand Publicity,GI-Bro,24992634,106488,78462,28026,2022-08-15
2297,Nintendo Technologies,Brand Publicity,Transmorphers,42223155,106487,26920,79567,2022-09-25
1006,Meta Platforms,E-Commerce,Merf,59183088,106438,46268,60170,2022-07-15
2455,Nintendo Technologies,Brand Publicity,Clay-Dough,41423736,106383,24635,81748,2022-09-27
4489,Google Inc.,Brand Publicity,Transmorphers,79422010,106338,41133,65205,2022-09-30
717,Nintendo Technologies,Media Supported Asset,Merf,77183181,106311,39346,66965,2022-09-11
757,The Martingale Agency,E-Commerce,Merf,16648466,106306,42543,63763,2022-11-18
2565,TikTok Inc,E-Commerce,Merf,11644456,106269,11510,94759,2022-08-20
2759,Pinterest Inc,Brand Publicity,Transmorphers,57099345,106210,32768,73442,2022-10-03
1229,Nintendo Technologies,Brand Asset Development,Transmorphers,94978170,106144,49362,56782,2022-09-17
1401,Disney Studios,E-Commerce,Merf,24401235,106098,63912,42186,2022-07-13
4132,Pinterest Inc,E-Commerce,Clay-Dough,77000372,106083,24499,81584,2022-12-06
278,The Martingale Agency,E-Commerce,Clay-Dough,49741311,106073,45221,60852,2022-11-27
2116,Disney Studios,Brand Asset Development,Clay-Dough,47764482,105809,77444,28365,2022-08-30
4622,TikTok Inc,Influencer,Merf,59828939,105802,24857,80945,2022-09-07
1734,Meta Platforms,Brand Publicity,Clay-Dough,70131786,105772,29184,76588,2022-12-25
4066,Nintendo Technologies,Media Supported Asset,Merf,46441763,105768,16284,89484,2022-11-14
1799,Disney Studios,Brand Publicity,Merf,16158821,105713,1254,104459,2022-07-01
1711,Disney Studios,Media Supported Asset,Clay-Dough,83944937,105668,13712,91956,2022-10-30
1056,Disney Studios,Brand Asset Development,Transmorphers,27607570,105643,25819,79824,2022-07-06
1228,Meta Platforms,E-Commerce,Clay-Dough,62158570,105623,20805,84818,2022-10-09
4803,Nintendo Technologies,Brand Asset Development,Transmorphers,95389193,105557,72540,33017,2022-08-07
2717,Disney Studios,E-Commerce,GI-Bro,44704893,105470,39654,65816,2022-10-05
4927,Nintendo Technologies,E-Commerce,Space Wars,37717976,105421,5705,99716,2022-08-27
3081,Disney Studios,E-Commerce,Space Wars,95464097,105379,37215,68164,2022-07-15
2589,The Martingale Agency,Brand Publicity,Space Wars,93396582,105367,41788,63579,2022-09-19
2929,Meta Platforms,Influencer,Clay-Dough,70135144,105363,41870,63493,2022-08-08
988,KYG Antler LLC,Brand Publicity,GI-Bro,54320875,105360,52892,52468,2022-07-26
3237,Disney Studios,Brand Asset Development,Clay-Dough,80601975,105350,3757,101593,2022-10-24
123,Pinterest Inc,Brand Publicity,Transmorphers,24122091,105350,53884,51466,2022-12-19
2809,Nintendo Technologies,Brand Asset Development,Merf,31095171,105339,69456,35883,2022-09-09
1421,KYG Antler LLC,Media Supported Asset,Transmorphers,88049266,105334,74249,31085,2022-09-28
2700,Nintendo Technologies,Brand Publicity,Transmorphers,48058595,105276,50581,54695,2022-12-17
3752,Nintendo Technologies,Brand Publicity,Clay-Dough,93878055,105275,40685,64590,2022-12-13
3611,Meta Platforms,Influencer,Space Wars,83436695,105242,51398,53844,2022-09-13
267,The Martingale Agency,Influencer,Transmorphers,27537971,105196,51153,54043,2022-10-18
3425,Google Inc.,Influencer,GI-Bro,86715965,105066,34005,71061,2022-11-23
2022,Disney Studios,Influencer,Merf,50278563,105060,38029,67031,2022-10-03
4764,Nintendo Technologies,Brand Asset Development,Merf,55113211,105059,72470,32589,2022-09-24
4713,Meta Platforms,E-Commerce,Space Wars,66612689,105019,26,104993,2022-10-24
4115,Pinterest Inc,Influencer,Transmorphers,78082946,105005,60480,44525,2022-08-27
4926,TikTok Inc,E-Commerce,Space Wars,24977377,104997,28795,76202,2022-11-16
4947,The Martingale Agency,Media Supported Asset,GI-Bro,44378035,104908,78288,26620,2022-08-22
855,Google Inc.,Influencer,Clay-Dough,14031624,104892,63795,41097,2022-09-30
1411,Pinterest Inc,Influencer,Clay-Dough,92566541,104795,8354,96441,2022-08-03
1349,Meta Platforms,Influencer,Clay-Dough,58812867,104715,47639,57076,2022-07-25
249,Nintendo Technologies,E-Commerce,GI-Bro,88989766,104704,38041,66663,2022-11-07
1193,TikTok Inc,Influencer,Transmorphers,77138755,104593,30315,74278,2022-10-10
2256,Pinterest Inc,Brand Asset Development,GI-Bro,21060314,104524,56397,48127,2022-08-20
3331,TikTok Inc,Brand Asset Development,Transmorphers,85376355,104407,483,103924,2022-10-18
1154,Nintendo Technologies,E-Commerce,Merf,81192680,104300,37556,66744,2022-11-01
2957,The Martingale Agency,Brand Asset Development,Merf,55054505,104292,3022,101270,2022-07-29
2518,The Martingale Agency,Media Supported Asset,Transmorphers,41924812,104274,52838,51436,2022-12-02
3090,The Martingale Agency,Influencer,Clay-Dough,46591565,104259,48454,55805,2022-12-16
3304,TikTok Inc,E-Commerce,GI-Bro,37345088,104248,25979,78269,2022-08-26
2672,Pinterest Inc,Influencer,Space Wars,14859601,104180,53016,51164,2022-08-16
24,Pinterest Inc,Brand Publicity,Transmorphers,21266238,104143,51699,52444,2022-12-21
3938,KYG Antler LLC,Brand Asset Development,GI-Bro,80774831,104066,53841,50225,2022-12-02
3321,Google Inc.,Brand Asset Development,Merf,13951701,104019,75175,28844,2022-08-17
832,Pinterest Inc,Influencer,Clay-Dough,94314511,103990,25501,78489,2022-07-19
3314,TikTok Inc,E-Commerce,Clay-Dough,27040549,103897,14333,89564,2022-10-02
3501,TikTok Inc,Brand Publicity,Clay-Dough,33437923,103876,64216,39660,2022-07-18
2250,KYG Antler LLC,Brand Asset Development,GI-Bro,38004496,103764,26609,77155,2022-11-25
2651,Google Inc.,Influencer,Merf,91859326,103677,45457,58220,2022-11-12
156,Nintendo Technologies,Brand Publicity,Transmorphers,92801684,103641,45743,57898,2022-12-25
1236,Disney Studios,E-Commerce,Merf,26587765,103593,16847,86746,2022-12-18
1020,Meta Platforms,Brand Publicity,Clay-Dough,89730361,103590,18285,85305,2022-10-23
2913,TikTok Inc,Influencer,GI-Bro,94159416,103557,43408,60149,2022-08-17
3823,The Martingale Agency,E-Commerce,GI-Bro,31841080,103473,14060,89413,2022-09-06
1284,The Martingale Agency,Brand Asset Development,GI-Bro,80628741,103452,31214,72238,2022-08-19
4180,Nintendo Technologies,Brand Asset Development,Clay-Dough,69441401,103417,31297,72120,2022-08-11
3915,Nintendo Technologies,Brand Asset Development,Space Wars,37558517,103299,54042,49257,2022-08-18
3227,Disney Studios,Brand Publicity,Merf,93603008,103266,63720,39546,2022-08-30
3217,Meta Platforms,Media Supported Asset,Merf,20736989,103246,53938,49308,2022-09-17
3172,Nintendo Technologies,Influencer,Merf,83065355,103183,60820,42363,2022-07-03
555,Google Inc.,Brand Asset Development,Transmorphers,21113479,103181,59080,44101,2022-07-25
261,TikTok Inc,Influencer,Transmorphers,30292955,103181,3309,99872,2022-09-12
3453,The Martingale Agency,Brand Publicity,Clay-Dough,49020123,103155,22818,80337,2022-10-08
4850,The Martingale Agency,Influencer,Merf,34465079,103115,20798,82317,2022-09-20
4349,KYG Antler LLC,Brand Publicity,Transmorphers,22845622,103089,58805,44284,2022-09-02
2882,Pinterest Inc,E-Commerce,Clay-Dough,35769166,103027,78019,25008,2022-08-28
206,KYG Antler LLC,Brand Asset Development,Clay-Dough,18780674,102947,2427,100520,2022-08-09
3202,Meta Platforms,E-Commerce,GI-Bro,39679666,102832,5802,97030,2022-07-18
189,The Martingale Agency,Brand Publicity,GI-Bro,44127975,102807,12886,89921,2022-12-09
997,The Martingale Agency,Media Supported Asset,Clay-Dough,29969791,102784,45612,57172,2022-09-10
4481,Google Inc.,Influencer,Merf,31524364,102779,30894,71885,2022-12-25
419,Google Inc.,Brand Publicity,Clay-Dough,87488669,102778,47322,55456,2022-12-24
2091,TikTok Inc,Brand Asset Development,Merf,10915799,102704,19530,83174,2022-09-23
2132,The Martingale Agency,Media Supported Asset,Clay-Dough,95473453,102675,9641,93034,2022-11-13
1931,Disney Studios,Influencer,Clay-Dough,41360329,102673,37335,65338,2022-10-23
990,Nintendo Technologies,Brand Asset Development,Merf,67442629,102659,11509,91150,2022-10-24
751,Pinterest Inc,Brand Publicity,GI-Bro,23271370,102633,50470,52163,2022-09-06
3704,TikTok Inc,E-Commerce,Space Wars,81140438,102631,42187,60444,2022-11-30
4956,The Martingale Agency,Influencer,Merf,66973446,102616,72721,29895,2022-09-02
4779,Meta Platforms,E-Commerce,Merf,42885655,102593,1590,101003,2022-09-29
1317,KYG Antler LLC,Media Supported Asset,GI-Bro,76232664,102591,7343,95248,2022-08-23
2821,TikTok Inc,Media Supported Asset,Space Wars,32479350,102425,25554,76871,2022-08-23
1898,The Martingale Agency,Brand Publicity,Transmorphers,79793394,102416,19915,82501,2022-10-26
2335,The Martingale Agency,Media Supported Asset,Clay-Dough,49124105,102395,29119,73276,2022-12-01
3002,The Martingale Agency,E-Commerce,Space Wars,79031720,102391,45895,56496,2022-10-11
1458,TikTok Inc,Influencer,GI-Bro,36760347,102382,42332,60050,2022-11-13
219,Disney Studios,Influencer,GI-Bro,96421317,102378,39248,63130,2022-08-13
1605,Disney Studios,E-Commerce,Clay-Dough,19132134,102365,57495,44870,2022-09-21
2400,Meta Platforms,Media Supported Asset,Merf,75684312,102364,68942,33422,2022-09-07
2010,The Martingale Agency,Brand Asset Development,GI-Bro,65998903,102353,8435,93918,2022-10-05
4309,Meta Platforms,Brand Asset Development,GI-Bro,44051821,102108,53049,49059,2022-09-27
490,KYG Antler LLC,Influencer,Transmorphers,28612135,102023,7292,94731,2022-12-17
4522,Disney Studios,Influencer,Space Wars,49036461,102000,36197,65803,2022-09-22
467,Nintendo Technologies,Brand Asset Development,Space Wars,63818523,101988,43115,58873,2022-08-15
1398,TikTok Inc,E-Commerce,Clay-Dough,54817497,101973,4631,97342,2022-07-19
2941,Disney Studios,Media Supported Asset,GI-Bro,86104184,101971,45418,56553,2022-09-12
1844,The Martingale Agency,Brand Publicity,Merf,78485261,101969,33656,68313,2022-11-20
4113,Disney Studios,Influencer,Merf,20318809,101902,37579,64323,2022-10-05
2150,Disney Studios,E-Commerce,Clay-Dough,68485285,101888,27407,74481,2022-11-19
1249,Pinterest Inc,Media Supported Asset,GI-Bro,65736358,101861,43202,58659,2022-11-28
2696,The Martingale Agency,Brand Publicity,Merf,51993757,101788,62518,39270,2022-08-06
1890,KYG Antler LLC,E-Commerce,Space Wars,62277750,101777,35089,66688,2022-07-11
113,KYG Antler LLC,Brand Publicity,Merf,35209099,101759,48839,52920,2022-08-12
4551,TikTok Inc,Media Supported Asset,Transmorphers,43039964,101715,3572,98143,2022-08-05
2504,KYG Antler LLC,E-Commerce,GI-Bro,44105887,101678,5396,96282,2022-07-23
1136,Pinterest Inc,Brand Publicity,Space Wars,53646513,101669,27227,74442,2022-10-16
1529,KYG Antler LLC,Brand Asset Development,Transmorphers,73536773,101625,36345,65280,2022-09-13
1274,Meta Platforms,E-Commerce,Clay-Dough,94351249,101577,22547,79030,2022-08-20
2147,Meta Platforms,Brand Publicity,Clay-Dough,37719781,101571,66172,35399,2022-08-04
4508,Pinterest Inc,E-Commerce,Clay-Dough,98265547,101569,45085,56484,2022-12-05
2573,KYG Antler LLC,Brand Asset Development,Merf,95220619,101430,30870,70560,2022-11-11
825,Meta Platforms,E-Commerce,Merf,75440194,101400,2639,98761,2022-10-01
815,Nintendo Technologies,Brand Asset Development,Merf,78755528,101337,28898,72439,2022-10-07
62,Disney Studios,Media Supported Asset,Transmorphers,77442067,101284,29040,72244,2022-09-04
338,Google Inc.,E-Commerce,Space Wars,48494874,100980,29828,71152,2022-11-19
4934,Google Inc.,Brand Asset Development,Transmorphers,42707714,100887,12762,88125,2022-11-04
1812,Nintendo Technologies,Brand Asset Development,Clay-Dough,61763922,100884,1530,99354,2022-11-15
4058,Disney Studios,Influencer,Space Wars,49818045,100856,45471,55385,2022-12-24
1415,Google Inc.,Brand Publicity,Merf,29148983,100708,27318,73390,2022-12-21
4763,KYG Antler LLC,Influencer,Clay-Dough,74008841,100700,10962,89738,2022-08-09
4342,KYG Antler LLC,E-Commerce,Space Wars,17545791,100621,58945,41676,2022-07-06
4319,The Martingale Agency,Media Supported Asset,Transmorphers,72897095,100566,17909,82657,2022-09-18
4933,Google Inc.,Brand Publicity,Merf,36600668,100548,39539,61009,2022-12-15
3193,KYG Antler LLC,Media Supported Asset,Clay-Dough,65932649,100400,37183,63217,2022-10-12
2527,Disney Studios,Brand Asset Development,GI-Bro,84616911,100398,15780,84618,2022-10-04
2011,The Martingale Agency,Influencer,GI-Bro,43345292,100344,5060,95284,2022-10-02
3416,KYG Antler LLC,Brand Asset Development,Clay-Dough,93332232,100264,8586,91678,2022-08-05
1556,Disney Studios,Media Supported Asset,Merf,56909912,100190,14097,86093,2022-10-27
1367,Pinterest Inc,Brand Asset Development,GI-Bro,48911775,100147,44325,55822,2022-11-08
1572,Meta Platforms,Influencer,Merf,23605597,100140,8765,91375,2022-12-15
2332,KYG Antler LLC,Brand Asset Development,Transmorphers,20331043,100128,59271,40857,2022-07-15
650,Pinterest Inc,E-Commerce,GI-Bro,47074915,100062,36053,64009,2022-07-22
197,Meta Platforms,Influencer,Clay-Dough,77014849,100044,12506,87538,2022-09-10
2397,Meta Platforms,Brand Publicity,GI-Bro,26310406,99997,26619,73378,2022-09-08
4495,Pinterest Inc,Brand Asset Development,Merf,72006388,99994,51082,48912,2022-04-27
1794,Pinterest Inc,Brand Publicity,Transmorphers,89906215,99986,31697,68289,2022-10-14
4459,KYG Antler LLC,Influencer,Space Wars,28374951,99980,85536,14444,2022-02-09
4091,Pinterest Inc,Media Supported Asset,GI-Bro,41302710,99966,59233,40733,2022-09-29
4504,TikTok Inc,E-Commerce,Merf,72404583,99946,14614,85332,2022-07-10
2900,TikTok Inc,Media Supported Asset,Space Wars,14116825,99921,42807,57114,2022-04-06
1265,Disney Studios,Media Supported Asset,Merf,89281850,99895,30933,68962,2022-03-05
3901,Disney Studios,Media Supported Asset,Transmorphers,44862233,99872,50412,49460,2022-09-09
3598,Meta Platforms,Media Supported Asset,Merf,66475190,99860,10776,89084,2022-09-12
4819,Nintendo Technologies,Influencer,Clay-Dough,83441583,99832,30663,69169,2022-08-18
2690,Nintendo Technologies,Brand Asset Development,Merf,29292238,99828,61126,38702,2022-09-05
1892,The Martingale Agency,E-Commerce,GI-Bro,79235450,99811,53351,46460,2022-01-29
4912,Meta Platforms,Brand Asset Development,Transmorphers,83807646,99781,24998,74783,2022-04-26
4871,TikTok Inc,Brand Asset Development,Merf,56119795,99767,46732,53035,2022-10-05
636,Nintendo Technologies,Influencer,Clay-Dough,58779255,99727,54580,45147,2022-08-12
1288,Pinterest Inc,Influencer,Transmorphers,11847782,99698,10599,89099,2022-11-08
3474,KYG Antler LLC,Brand Asset Development,Space Wars,31205345,99684,52310,47374,2022-08-17
4008,TikTok Inc,Influencer,Merf,41589293,99672,20142,79530,2022-12-10
4147,Nintendo Technologies,Brand Publicity,GI-Bro,58934684,99672,38566,61106,2022-09-03
1684,TikTok Inc,Influencer,GI-Bro,61565332,99671,22693,76978,2022-08-29
4040,Pinterest Inc,Brand Asset Development,GI-Bro,88684849,99665,46491,53174,2022-05-19
3715,Nintendo Technologies,Brand Asset Development,GI-Bro,65999409,99629,52282,47347,2022-08-20
3798,Meta Platforms,E-Commerce,Transmorphers,20195620,99601,19543,80058,2022-02-09
4216,Pinterest Inc,Brand Asset Development,Transmorphers,36640683,99591,3834,95757,2022-06-07
1007,The Martingale Agency,E-Commerce,Clay-Dough,39111676,99590,23543,76047,2022-01-05
2659,The Martingale Agency,Media Supported Asset,Clay-Dough,30644969,99588,2702,96886,2022-10-14
4608,Nintendo Technologies,Media Supported Asset,Merf,23080968,99585,54312,45273,2022-06-30
3342,Pinterest Inc,Media Supported Asset,Transmorphers,51054517,99527,17016,82511,2022-08-20
3603,TikTok Inc,Influencer,GI-Bro,16153590,99481,28639,70842,2022-08-17
1680,TikTok Inc,Brand Publicity,GI-Bro,45430636,99479,29624,69855,2022-08-08
4533,KYG Antler LLC,Influencer,Clay-Dough,21650138,99473,17333,82140,2022-02-08
2959,Disney Studios,E-Commerce,Merf,18066755,99411,11325,88086,2022-09-25
2987,Nintendo Technologies,Influencer,Transmorphers,94830565,99398,42667,56731,2022-01-28
3541,The Martingale Agency,Brand Publicity,Merf,84443789,99358,53969,45389,2022-04-18
1032,Nintendo Technologies,Brand Publicity,Space Wars,84862611,99339,11670,87669,2022-12-16
1675,Pinterest Inc,Media Supported Asset,Transmorphers,37146611,99339,33459,65880,2022-07-12
3080,The Martingale Agency,Brand Asset Development,Merf,85273718,99319,79088,20231,2022-02-02
2654,KYG Antler LLC,Media Supported Asset,Merf,98540690,99318,19642,79676,2022-04-28
2037,Google Inc.,Brand Publicity,GI-Bro,70289537,99268,2505,96763,2022-12-16
3327,KYG Antler LLC,Brand Asset Development,GI-Bro,98141831,99264,15546,83718,2022-12-05
468,TikTok Inc,Media Supported Asset,Merf,69176622,99245,64160,35085,2022-07-14
834,Disney Studios,Brand Asset Development,Space Wars,11362503,99224,11138,88086,2022-01-15
4822,Nintendo Technologies,Brand Asset Development,Clay-Dough,64991004,99195,4107,95088,2022-10-17
224,The Martingale Agency,Influencer,Transmorphers,86297277,99194,21064,78130,2022-11-24
501,KYG Antler LLC,Brand Publicity,Transmorphers,61224813,99191,9467,89724,2022-10-29
3246,Google Inc.,Brand Asset Development,Transmorphers,40854078,99134,23996,75138,2022-01-26
4874,Nintendo Technologies,Brand Publicity,Space Wars,57810680,99130,46942,52188,2022-10-11
3248,The Martingale Agency,Influencer,Space Wars,72681863,99095,18188,80907,2022-03-10
2807,KYG Antler LLC,E-Commerce,GI-Bro,48855515,99060,5455,93605,2022-04-20
3966,Nintendo Technologies,Media Supported Asset,Merf,39754139,99023,59205,39818,2022-06-26
1994,KYG Antler LLC,E-Commerce,Transmorphers,48283282,99014,19291,79723,2022-09-14
398,KYG Antler LLC,Brand Asset Development,Transmorphers,88361679,98997,88121,10876,2022-04-07
2221,Meta Platforms,Media Supported Asset,Clay-Dough,76789459,98961,2991,95970,2022-03-08
2520,Disney Studios,Brand Asset Development,Space Wars,24252723,98942,51569,47373,2022-09-25
4462,Meta Platforms,E-Commerce,GI-Bro,40898439,98924,53490,45434,2022-01-18
3898,KYG Antler LLC,E-Commerce,Clay-Dough,54559064,98924,23530,75394,2022-11-18
2453,Disney Studios,Influencer,Clay-Dough,57969817,98914,61745,37169,2022-09-27
3164,Meta Platforms,E-Commerce,Space Wars,17512679,98911,96715,2196,2022-01-11
87,KYG Antler LLC,Brand Publicity,Merf,99314835,98878,13142,85736,2022-06-30
4453,Disney Studios,E-Commerce,Clay-Dough,47191707,98877,89010,9867,2022-05-19
263,The Martingale Agency,Media Supported Asset,Transmorphers,92279468,98876,15475,83401,2022-10-29
3266,Pinterest Inc,Brand Asset Development,Space Wars,78750919,98855,34165,64690,2022-05-28
399,Pinterest Inc,Brand Asset Development,Space Wars,80865699,98850,27605,71245,2022-03-20
3800,TikTok Inc,Media Supported Asset,Space Wars,64906802,98776,44589,54187,2022-12-05
991,Pinterest Inc,Brand Publicity,GI-Bro,40616438,98769,39849,58920,2022-10-17
2322,Google Inc.,Media Supported Asset,Space Wars,71754685,98753,29916,68837,2022-01-16
3777,Meta Platforms,Brand Asset Development,Merf,12398391,98735,1215,97520,2022-09-15
2063,KYG Antler LLC,Media Supported Asset,Transmorphers,60957563,98690,47980,50710,2022-06-26
4274,The Martingale Agency,Influencer,Merf,27177848,98637,840,97797,2022-08-04
3977,KYG Antler LLC,Brand Publicity,Clay-Dough,42788221,98622,39373,59249,2022-12-16
934,Nintendo Technologies,Media Supported Asset,Transmorphers,58033543,98616,63888,34728,2022-07-09
4081,Disney Studios,Influencer,Merf,24770129,98605,67545,31060,2022-08-18
4974,The Martingale Agency,Influencer,Clay-Dough,31342847,98603,57813,40790,2022-02-01
1350,KYG Antler LLC,E-Commerce,Clay-Dough,64541940,98581,2971,95610,2022-07-24
4834,KYG Antler LLC,Brand Publicity,Space Wars,60219808,98565,7876,90689,2022-08-10
1396,Pinterest Inc,E-Commerce,Transmorphers,88467344,98534,15225,83309,2022-03-31
1436,KYG Antler LLC,Influencer,Clay-Dough,45038076,98511,29668,68843,2022-02-05
2899,Google Inc.,Brand Publicity,Clay-Dough,68848605,98481,68992,29489,2022-02-11
25,The Martingale Agency,Brand Asset Development,GI-Bro,22239959,98465,34485,63980,2022-04-21
3039,KYG Antler LLC,Media Supported Asset,Space Wars,65103035,98427,11541,86886,2022-04-18
4540,The Martingale Agency,Media Supported Asset,GI-Bro,40584458,98407,44826,53581,2022-11-12
2381,Google Inc.,Influencer,Merf,45893746,98400,44028,54372,2022-06-10
753,The Martingale Agency,E-Commerce,Merf,33173143,98396,36209,62187,2022-10-08
4636,Meta Platforms,Brand Publicity,GI-Bro,23516687,98373,26615,71758,2022-12-09
315,Google Inc.,Influencer,GI-Bro,97584346,98334,50556,47778,2022-04-28
4665,Nintendo Technologies,E-Commerce,Clay-Dough,30749746,98321,3353,94968,2022-10-16
1315,Meta Platforms,Influencer,GI-Bro,69386465,98311,63551,34760,2022-05-21
4989,Nintendo Technologies,E-Commerce,Transmorphers,84118259,98310,93838,4472,2022-06-04
572,Nintendo Technologies,Brand Asset Development,Transmorphers,66866062,98310,82095,16215,2022-03-09
216,KYG Antler LLC,Brand Asset Development,Merf,49404209,98267,79821,18446,2022-05-22
2719,Nintendo Technologies,Media Supported Asset,Merf,34961174,98248,59550,38698,2022-05-26
4273,TikTok Inc,Media Supported Asset,Transmorphers,14262010,98199,29730,68469,2022-10-08
2444,Google Inc.,Media Supported Asset,Transmorphers,25398108,98194,79290,18904,2022-01-25
3775,The Martingale Agency,E-Commerce,GI-Bro,60391099,98171,84393,13778,2022-01-12
161,Disney Studios,Brand Asset Development,Clay-Dough,59583846,98163,62253,35910,2022-08-26
1462,Google Inc.,Brand Publicity,Merf,62720583,98149,23660,74489,2022-02-03
3148,KYG Antler LLC,E-Commerce,GI-Bro,20172933,98119,65537,32582,2022-02-23
1836,TikTok Inc,E-Commerce,Space Wars,88311080,98113,46272,51841,2022-06-11
1115,KYG Antler LLC,Brand Publicity,Clay-Dough,65104651,98092,42962,55130,2022-03-26
3323,KYG Antler LLC,E-Commerce,Transmorphers,76373648,98032,39807,58225,2022-07-24
2755,Google Inc.,Influencer,Clay-Dough,18246829,98018,46467,51551,2022-09-29
1379,Google Inc.,Brand Asset Development,Transmorphers,12901005,97971,23546,74425,2022-08-15
260,KYG Antler LLC,Brand Publicity,Merf,56408129,97963,94366,3597,2022-02-10
1103,Nintendo Technologies,E-Commerce,Space Wars,96953951,97939,13706,84233,2022-03-26
333,KYG Antler LLC,Influencer,Merf,19928540,97932,20868,77064,2022-09-15
3518,Nintendo Technologies,Brand Publicity,Merf,17483327,97912,97146,766,2022-03-13
2516,Meta Platforms,Brand Publicity,Space Wars,77576879,97889,57390,40499,2022-08-25
2445,The Martingale Agency,E-Commerce,Transmorphers,36700421,97874,50828,47046,2022-07-28
849,The Martingale Agency,E-Commerce,Merf,84686721,97842,70762,27080,2022-02-02
3485,Disney Studios,Brand Asset Development,Transmorphers,60457665,97828,18011,79817,2022-10-14
4305,Pinterest Inc,Brand Publicity,Space Wars,89788569,97807,1426,96381,2022-12-13
2637,Google Inc.,Brand Publicity,Clay-Dough,81220906,97776,13275,84501,2022-11-25
2191,Pinterest Inc,Media Supported Asset,Transmorphers,11629413,97745,47159,50586,2022-12-04
494,Meta Platforms,Brand Asset Development,Merf,99945595,97741,23002,74739,2022-07-21
4782,Disney Studios,E-Commerce,Merf,24721362,97673,60022,37651,2022-01-21
1502,TikTok Inc,E-Commerce,Space Wars,62071793,97655,24005,73650,2022-08-24
4646,Pinterest Inc,Brand Asset Development,Transmorphers,38766603,97634,45946,51688,2022-10-01
4351,Disney Studios,Influencer,Clay-Dough,70798503,97588,12456,85132,2022-12-04
2529,Nintendo Technologies,E-Commerce,Space Wars,58821787,97585,15179,82406,2022-10-08
187,Pinterest Inc,Media Supported Asset,Space Wars,34430765,97569,72191,25378,2022-09-03
1791,TikTok Inc,Brand Publicity,Space Wars,29657082,97568,2063,95505,2022-11-16
4311,KYG Antler LLC,Influencer,Space Wars,61871852,97539,4130,93409,2022-06-10
3707,Disney Studios,E-Commerce,Clay-Dough,82823239,97524,33779,63745,2022-10-10
332,TikTok Inc,Brand Publicity,Merf,73684277,97505,31146,66359,2022-06-27
1789,The Martingale Agency,Brand Publicity,Clay-Dough,76712570,97497,31841,65656,2022-12-09
1906,TikTok Inc,Media Supported Asset,Clay-Dough,83013014,97446,33089,64357,2022-03-03
781,TikTok Inc,Media Supported Asset,Clay-Dough,48694256,97444,58031,39413,2022-09-17
4057,KYG Antler LLC,Brand Publicity,Clay-Dough,11367326,97427,42100,55327,2022-01-24
998,Meta Platforms,Media Supported Asset,Clay-Dough,90093430,97424,55803,41621,2022-08-06
1069,Meta Platforms,Brand Asset Development,Merf,47439070,97414,85337,12077,2022-04-13
3692,Pinterest Inc,E-Commerce,Clay-Dough,68251449,97409,93890,3519,2022-05-27
4206,Google Inc.,E-Commerce,Clay-Dough,19338443,97400,2940,94460,2022-05-19
269,Disney Studios,Brand Publicity,Space Wars,52968127,97385,73249,24136,2022-02-12
3178,Pinterest Inc,Brand Asset Development,Merf,62419276,97344,1535,95809,2022-03-25
183,Google Inc.,Media Supported Asset,Transmorphers,30066909,97340,67631,29709,2022-06-09
3250,Meta Platforms,Brand Publicity,Clay-Dough,61682724,97332,19060,78272,2022-10-21
3693,The Martingale Agency,E-Commerce,GI-Bro,21207853,97306,28076,69230,2022-08-31
1737,Nintendo Technologies,Media Supported Asset,Transmorphers,18208702,97212,38834,58378,2022-05-18
2956,Nintendo Technologies,Brand Asset Development,Clay-Dough,94946024,97104,49167,47937,2022-06-02
2483,Nintendo Technologies,Brand Publicity,Space Wars,23075556,97056,94453,2603,2022-03-01
4534,The Martingale Agency,Influencer,GI-Bro,42550713,97034,51794,45240,2022-02-02
914,Disney Studios,Media Supported Asset,Space Wars,87809294,96998,4173,92825,2022-11-17
3738,Disney Studios,Media Supported Asset,Transmorphers,96355611,96948,11792,85156,2022-12-20
4165,Google Inc.,Brand Asset Development,Transmorphers,38006757,96888,58464,38424,2022-08-28
2978,Nintendo Technologies,Influencer,Clay-Dough,53442189,96862,3857,93005,2022-11-06
307,Google Inc.,E-Commerce,Merf,31794593,96853,87125,9728,2022-03-19
322,Disney Studios,Brand Publicity,Transmorphers,69227721,96835,9171,87664,2022-05-24
796,Nintendo Technologies,Brand Publicity,Transmorphers,34633059,96828,1412,95416,2022-02-21
1696,Nintendo Technologies,Brand Publicity,Merf,29979174,96818,6462,90356,2022-01-04
1846,Disney Studios,Media Supported Asset,GI-Bro,88296996,96811,30035,66776,2022-09-10
3817,Pinterest Inc,Media Supported Asset,Clay-Dough,30336205,96810,31072,65738,2022-03-28
3211,Nintendo Technologies,Brand Asset Development,Merf,51177452,96793,74784,22009,2022-01-06
1793,Nintendo Technologies,E-Commerce,Space Wars,14099834,96736,84654,12082,2022-01-07
2681,KYG Antler LLC,Brand Asset Development,Space Wars,90064683,96726,82953,13773,2022-04-12
2258,Pinterest Inc,Brand Asset Development,GI-Bro,59449480,96724,42470,54254,2022-01-03
535,Pinterest Inc,E-Commerce,Space Wars,94601487,96723,16902,79821,2022-11-27
2596,Disney Studios,E-Commerce,GI-Bro,26947893,96717,35459,61258,2022-10-25
2275,Google Inc.,Brand Publicity,Merf,56434595,96702,41464,55238,2022-12-22
2077,The Martingale Agency,Influencer,GI-Bro,62866469,96698,44140,52558,2022-08-17
3559,The Martingale Agency,Media Supported Asset,Space Wars,24077249,96673,21589,75084,2022-08-07
3460,Google Inc.,Brand Asset Development,Transmorphers,44702391,96666,53573,43093,2022-08-19
2912,Google Inc.,Brand Asset Development,GI-Bro,13355576,96655,13847,82808,2022-11-06
1526,KYG Antler LLC,Influencer,Clay-Dough,83727572,96635,25369,71266,2022-08-25
304,Pinterest Inc,Media Supported Asset,Merf,77989096,96620,51269,45351,2022-02-16
1617,Nintendo Technologies,Influencer,GI-Bro,73835290,96506,62389,34117,2022-05-09
916,Meta Platforms,E-Commerce,Clay-Dough,97429037,96501,3531,92970,2022-10-31
2299,Pinterest Inc,E-Commerce,GI-Bro,18995777,96485,63815,32670,2022-07-27
4067,KYG Antler LLC,E-Commerce,Transmorphers,86011432,96471,39087,57384,2022-11-13
2962,Google Inc.,Media Supported Asset,Space Wars,75654558,96461,35371,61090,2022-12-16
1314,KYG Antler LLC,E-Commerce,Clay-Dough,45470631,96417,15225,81192,2022-11-17
4991,Nintendo Technologies,Media Supported Asset,GI-Bro,70016991,96382,10333,86049,2022-06-29
2715,TikTok Inc,Media Supported Asset,GI-Bro,48079465,96360,75523,20837,2022-02-14
3352,TikTok Inc,Brand Publicity,Transmorphers,47972551,96333,1583,94750,2022-05-28
3307,Pinterest Inc,Brand Asset Development,Merf,92562444,96328,34231,62097,2022-05-07
1817,The Martingale Agency,Brand Asset Development,Clay-Dough,46617293,96317,9577,86740,2022-09-13
2838,Disney Studios,Influencer,Transmorphers,13751066,96313,42324,53989,2022-12-04
3953,TikTok Inc,Media Supported Asset,Space Wars,47433825,96303,20966,75337,2022-06-06
485,Pinterest Inc,Brand Publicity,Merf,35329260,96261,14382,81879,2022-09-14
2171,Pinterest Inc,Brand Asset Development,Clay-Dough,58105168,96209,35871,60338,2022-10-03
2186,The Martingale Agency,Brand Publicity,GI-Bro,66346593,96195,63110,33085,2022-08-18
4623,Meta Platforms,Brand Publicity,Clay-Dough,16066842,96170,31879,64291,2022-12-16
3261,Meta Platforms,Media Supported Asset,Merf,22662602,96168,14464,81704,2022-10-06
296,The Martingale Agency,Influencer,Transmorphers,63136045,96141,45083,51058,2022-07-22
715,The Martingale Agency,Brand Asset Development,GI-Bro,85513825,96117,25066,71051,2022-09-29
1525,Disney Studios,Brand Asset Development,Merf,82378912,96116,90692,5424,2022-04-06
3881,TikTok Inc,Brand Publicity,Space Wars,36209751,96113,5968,90145,2022-05-08
2939,TikTok Inc,E-Commerce,Transmorphers,12707700,96111,91450,4661,2022-03-31
1723,Nintendo Technologies,Brand Publicity,Transmorphers,64197451,96046,19287,76759,2022-12-05
826,The Martingale Agency,Brand Asset Development,Transmorphers,82119389,95993,14236,81757,2022-02-24
1586,Meta Platforms,Influencer,Merf,91012226,95980,11485,84495,2022-02-26
4917,Nintendo Technologies,Brand Asset Development,Clay-Dough,65853292,95969,39408,56561,2022-11-16
4781,KYG Antler LLC,Influencer,Clay-Dough,21895536,95935,15707,80228,2022-07-21
1065,Meta Platforms,Brand Asset Development,GI-Bro,14922228,95916,36496,59420,2022-12-05
3787,Nintendo Technologies,Influencer,Merf,95684269,95913,29217,66696,2022-11-07
2076,KYG Antler LLC,E-Commerce,Merf,18672480,95908,38710,57198,2022-12-13
4859,Nintendo Technologies,Brand Publicity,Space Wars,82257968,95896,49110,46786,2022-04-11
2728,Disney Studios,Brand Publicity,Merf,68378999,95885,41485,54400,2022-03-01
2456,Pinterest Inc,Influencer,GI-Bro,32576345,95857,44292,51565,2022-01-22
1212,Pinterest Inc,Media Supported Asset,Clay-Dough,35591228,95856,42371,53485,2022-02-16
2574,KYG Antler LLC,Brand Publicity,GI-Bro,36002872,95839,68887,26952,2022-06-30
1724,Meta Platforms,Media Supported Asset,Merf,53263948,95832,39513,56319,2022-12-26
3949,TikTok Inc,Brand Publicity,GI-Bro,95852590,95803,12904,82899,2022-11-18
2679,Pinterest Inc,E-Commerce,GI-Bro,67394944,95745,8204,87541,2022-04-29
1243,Pinterest Inc,Influencer,Merf,61140296,95723,43771,51952,2022-07-24
3156,The Martingale Agency,Brand Asset Development,GI-Bro,11505081,95719,56577,39142,2022-01-22
294,Nintendo Technologies,E-Commerce,Space Wars,28171828,95695,64037,31658,2022-09-26
4016,Nintendo Technologies,E-Commerce,GI-Bro,17407959,95658,10651,85007,2022-08-31
4915,KYG Antler LLC,E-Commerce,Transmorphers,47174413,95611,90792,4819,2022-05-05
4829,Disney Studios,Media Supported Asset,Transmorphers,74238351,95607,32341,63266,2022-11-19
4549,The Martingale Agency,Brand Asset Development,Clay-Dough,25205008,95601,20960,74641,2022-07-30
478,Pinterest Inc,Media Supported Asset,Space Wars,44837439,95599,69515,26084,2022-09-24
69,TikTok Inc,Brand Asset Development,Clay-Dough,32779021,95597,51473,44124,2022-02-17
2127,TikTok Inc,Influencer,Space Wars,68771548,95543,43780,51763,2022-07-06
3471,Pinterest Inc,Media Supported Asset,Transmorphers,27657369,95502,82709,12793,2022-03-02
1881,KYG Antler LLC,Brand Publicity,Transmorphers,65456259,95495,18542,76953,2022-02-26
1392,Meta Platforms,Brand Publicity,GI-Bro,53176560,95462,44932,50530,2022-05-17
886,Pinterest Inc,Brand Publicity,GI-Bro,95137405,95421,41987,53434,2022-12-24
471,Disney Studios,E-Commerce,Clay-Dough,68270648,95382,4532,90850,2022-10-10
3066,The Martingale Agency,Brand Publicity,Space Wars,20536590,95347,32181,63166,2022-09-10
4805,The Martingale Agency,E-Commerce,Clay-Dough,42743184,95332,51315,44017,2022-08-11
1722,KYG Antler LLC,E-Commerce,Clay-Dough,53490548,95317,61656,33661,2022-01-12
4199,The Martingale Agency,Brand Publicity,GI-Bro,56139180,95242,86649,8593,2022-01-03
4930,Pinterest Inc,E-Commerce,GI-Bro,78299119,95222,44958,50264,2022-06-28
2812,KYG Antler LLC,Influencer,Space Wars,45047132,95203,64093,31110,2022-04-21
1775,Nintendo Technologies,Influencer,Space Wars,65801772,95197,48218,46979,2022-06-12
9,Google Inc.,Brand Asset Development,Transmorphers,68631545,95129,1109,94020,2022-01-29
4073,Google Inc.,Brand Publicity,Space Wars,78598400,95120,37508,57612,2022-07-29
3345,The Martingale Agency,Influencer,GI-Bro,65621643,95075,61637,33438,2022-02-04
1509,TikTok Inc,Media Supported Asset,GI-Bro,68379051,95072,37482,57590,2022-12-26
978,Nintendo Technologies,E-Commerce,Space Wars,13832841,95038,5546,89492,2022-11-02
4007,The Martingale Agency,Brand Publicity,GI-Bro,33757015,95032,5221,89811,2022-08-02
2994,KYG Antler LLC,Brand Publicity,Merf,10220377,95027,75092,19935,2022-02-04
3825,TikTok Inc,Influencer,Transmorphers,10476425,95006,33015,61991,2022-11-25
3643,The Martingale Agency,Brand Asset Development,Transmorphers,71358338,94930,14381,80549,2022-11-26
2878,Google Inc.,Brand Asset Development,Space Wars,27706253,94919,61147,33772,2022-06-28
714,KYG Antler LLC,Influencer,Clay-Dough,51609600,94917,10093,84824,2022-12-10
4749,Pinterest Inc,Brand Publicity,Transmorphers,48444197,94899,61520,33379,2022-07-03
2376,TikTok Inc,Brand Asset Development,Space Wars,99790811,94874,6969,87905,2022-03-06
3593,Meta Platforms,Media Supported Asset,Clay-Dough,93599477,94861,72199,22662,2022-05-31
1102,TikTok Inc,Brand Publicity,GI-Bro,25484845,94859,33924,60935,2022-08-22
2932,Google Inc.,Brand Publicity,Merf,63823447,94823,811,94012,2022-07-30
3581,KYG Antler LLC,E-Commerce,Transmorphers,63485117,94803,42102,52701,2022-05-16
2085,Disney Studios,Media Supported Asset,Space Wars,63764208,94796,35577,59219,2022-07-18
4584,TikTok Inc,Media Supported Asset,GI-Bro,52123602,94743,22398,72345,2022-10-05
2298,Meta Platforms,Brand Asset Development,Merf,55973773,94742,35837,58905,2022-06-06
4391,The Martingale Agency,Influencer,Merf,40822769,94740,83534,11206,2022-06-24
1784,Google Inc.,E-Commerce,Space Wars,85279177,94696,63962,30734,2022-05-11
1518,The Martingale Agency,Media Supported Asset,GI-Bro,64834300,94690,8205,86485,2022-08-27
3497,Nintendo Technologies,E-Commerce,Merf,70918460,94689,26768,67921,2022-07-17
4056,Disney Studios,Brand Publicity,Merf,38534013,94679,63048,31631,2022-05-09
626,Nintendo Technologies,Influencer,Space Wars,58894769,94673,18011,76662,2022-10-06
1281,Meta Platforms,Media Supported Asset,Transmorphers,52902181,94668,41889,52779,2022-10-06
1342,Disney Studios,E-Commerce,Merf,23868716,94663,13007,81656,2022-12-23
2315,Google Inc.,Brand Publicity,Merf,99005608,94631,32703,61928,2022-06-28
3998,Meta Platforms,Brand Publicity,Space Wars,49124161,94619,65331,29288,2022-03-08
1534,KYG Antler LLC,E-Commerce,GI-Bro,11758787,94614,82785,11829,2022-03-07
2990,TikTok Inc,Brand Asset Development,Merf,22703810,94610,1966,92644,2022-04-27
37,The Martingale Agency,Influencer,Space Wars,99398671,94607,28080,66527,2022-12-01
320,Meta Platforms,Media Supported Asset,Transmorphers,85936293,94604,49491,45113,2022-05-30
937,The Martingale Agency,Brand Asset Development,Clay-Dough,73548326,94604,730,93874,2022-08-09
3801,The Martingale Agency,Brand Publicity,Clay-Dough,14455174,94594,60363,34231,2022-08-20
4732,KYG Antler LLC,Brand Publicity,Clay-Dough,31106460,94540,58043,36497,2022-02-21
1471,The Martingale Agency,E-Commerce,Transmorphers,49594036,94511,17571,76940,2022-04-07
4787,Meta Platforms,Media Supported Asset,Clay-Dough,47973486,94503,92159,2344,2022-04-18
1637,KYG Antler LLC,Influencer,Space Wars,84048261,94500,59782,34718,2022-08-14
1199,Meta Platforms,Brand Publicity,Clay-Dough,68041003,94492,67019,27473,2022-09-11
4477,Pinterest Inc,Brand Publicity,Clay-Dough,48877416,94491,8330,86161,2022-07-06
392,Pinterest Inc,Brand Asset Development,Merf,36950394,94488,21330,73158,2022-10-23
3928,TikTok Inc,Brand Asset Development,GI-Bro,70739167,94462,57053,37409,2022-06-28
3650,Google Inc.,E-Commerce,Clay-Dough,24490843,94449,13785,80664,2022-05-06
718,KYG Antler LLC,Influencer,Space Wars,99459492,94416,32535,61881,2022-05-26
723,The Martingale Agency,E-Commerce,Clay-Dough,31969741,94404,19093,75311,2022-07-04
3627,Meta Platforms,Brand Asset Development,Merf,60270519,94394,16337,78057,2022-01-14
928,Meta Platforms,Brand Asset Development,Clay-Dough,76134609,94340,82214,12126,2022-01-13
2525,Disney Studios,Brand Publicity,GI-Bro,15900065,94325,6593,87732,2022-12-02
536,TikTok Inc,Media Supported Asset,Merf,26120879,94317,36978,57339,2022-11-26
3023,The Martingale Agency,Brand Publicity,Transmorphers,42892804,94294,9809,84485,2022-10-22
3132,Disney Studios,Brand Publicity,Merf,96125132,94255,62511,31744,2022-01-05
828,Disney Studios,Brand Publicity,Clay-Dough,35185959,94200,50314,43886,2022-05-11
2643,The Martingale Agency,Media Supported Asset,Clay-Dough,72060116,94150,41221,52929,2022-03-09
1376,Disney Studios,Influencer,Merf,29295478,94149,34271,59878,2022-10-04
2753,Nintendo Technologies,E-Commerce,Transmorphers,50848840,94143,51185,42958,2022-02-19
2613,Meta Platforms,Media Supported Asset,GI-Bro,82470078,94123,867,93256,2022-02-04
2980,Disney Studios,Influencer,Transmorphers,73483919,94093,78647,15446,2022-04-20
4648,Nintendo Technologies,Media Supported Asset,Merf,24875040,94077,776,93301,2022-06-19
3893,The Martingale Agency,Influencer,Transmorphers,50339901,94068,76624,17444,2022-05-11
1207,Pinterest Inc,Brand Asset Development,Transmorphers,89125316,94044,37881,56163,2022-09-12
2199,Meta Platforms,Brand Asset Development,GI-Bro,24485741,94019,39734,54285,2022-12-24
2192,Meta Platforms,E-Commerce,Merf,94125919,93966,24838,69128,2022-03-06
3465,Nintendo Technologies,E-Commerce,Merf,45606203,93925,81748,12177,2022-03-20
2577,Google Inc.,Media Supported Asset,Transmorphers,78923813,93888,31440,62448,2022-12-23
4566,Pinterest Inc,E-Commerce,GI-Bro,61446438,93879,40621,53258,2022-11-11
1777,TikTok Inc,Brand Publicity,Merf,54403844,93869,74559,19310,2022-01-10
4759,Nintendo Technologies,Brand Publicity,GI-Bro,61235541,93854,7396,86458,2022-12-05
976,The Martingale Agency,Brand Asset Development,Clay-Dough,48947147,93830,34621,59209,2022-08-02
3259,The Martingale Agency,Influencer,Space Wars,73459583,93804,34812,58992,2022-10-15
1578,The Martingale Agency,Media Supported Asset,Clay-Dough,57751565,93791,19211,74580,2022-01-04
2123,Disney Studios,Brand Asset Development,GI-Bro,70104426,93757,68524,25233,2022-09-23
3407,Google Inc.,Influencer,Transmorphers,47847385,93713,29482,64231,2022-11-29
1755,Google Inc.,Brand Asset Development,GI-Bro,53119870,93709,28663,65046,2022-05-24
3094,TikTok Inc,Media Supported Asset,Merf,76660211,93702,7469,86233,2022-01-15
2658,Meta Platforms,Brand Publicity,Space Wars,35399398,93700,24896,68804,2022-07-28
10,Meta Platforms,Media Supported Asset,Transmorphers,20614553,93664,81619,12045,2022-02-19
4443,Pinterest Inc,Influencer,Clay-Dough,75225943,93635,41291,52344,2022-08-20
3897,Pinterest Inc,E-Commerce,Space Wars,10367076,93623,41666,51957,2022-03-18
1388,The Martingale Agency,Brand Asset Development,Merf,82358576,93595,15850,77745,2022-08-12
1092,The Martingale Agency,Brand Asset Development,Space Wars,29895129,93556,59763,33793,2022-04-20
4331,Pinterest Inc,Influencer,GI-Bro,75153334,93555,35300,58255,2022-11-14
4969,TikTok Inc,Media Supported Asset,Transmorphers,98189361,93546,17541,76005,2022-07-22
901,Disney Studios,Brand Publicity,Clay-Dough,70386768,93542,74305,19237,2022-02-12
1504,TikTok Inc,Brand Publicity,Transmorphers,63143740,93533,2956,90577,2022-08-10
4330,Nintendo Technologies,Influencer,Transmorphers,32198888,93532,8244,85288,2022-06-27
234,The Martingale Agency,E-Commerce,Clay-Dough,62311311,93531,13106,80425,2022-11-02
627,Meta Platforms,Brand Asset Development,Space Wars,99665546,93526,68797,24729,2022-06-16
3816,Nintendo Technologies,Media Supported Asset,GI-Bro,89601964,93501,59660,33841,2022-02-23
1162,Disney Studios,E-Commerce,Space Wars,39400037,93487,2921,90566,2022-09-22
1320,KYG Antler LLC,Media Supported Asset,Clay-Dough,98023504,93478,805,92673,2022-11-28
4378,TikTok Inc,E-Commerce,Transmorphers,58644321,93463,64955,28508,2022-05-10
3392,The Martingale Agency,Brand Publicity,Transmorphers,53390791,93463,12317,81146,2022-07-14
1786,Meta Platforms,Influencer,Space Wars,93627325,93452,19933,73519,2022-03-07
3372,Nintendo Technologies,E-Commerce,GI-Bro,57731244,93450,11800,81650,2022-08-01
1468,Disney Studios,Influencer,Transmorphers,20446346,93444,45004,48440,2022-05-11
497,The Martingale Agency,E-Commerce,Merf,37641786,93417,36802,56615,2022-11-01
2157,Disney Studios,Media Supported Asset,GI-Bro,18702060,93414,37253,56161,2022-08-30
737,TikTok Inc,Media Supported Asset,GI-Bro,31022903,93378,61622,31756,2022-07-25
93,Meta Platforms,Media Supported Asset,GI-Bro,89342102,93340,26401,66939,2022-10-14
4979,Disney Studios,Influencer,Transmorphers,65512470,93335,57465,35870,2022-07-09
4486,Google Inc.,Brand Publicity,GI-Bro,30627656,93332,61921,31411,2022-09-15
3925,Pinterest Inc,Brand Publicity,Clay-Dough,69476308,93304,39082,54222,2022-08-27
2600,TikTok Inc,Brand Publicity,Clay-Dough,86218712,93238,38478,54760,2022-04-08
2394,TikTok Inc,Media Supported Asset,Merf,72296988,93236,62941,30295,2022-02-21
1135,Meta Platforms,Brand Asset Development,Clay-Dough,81863285,93224,88227,4997,2022-05-10
3990,Meta Platforms,E-Commerce,Merf,48778956,93162,9782,83380,2022-12-15
1867,Nintendo Technologies,Media Supported Asset,Merf,42873656,93147,75129,18018,2022-05-25
4149,Google Inc.,Influencer,Transmorphers,82092631,93141,35871,57270,2022-12-23
229,Disney Studios,Brand Asset Development,GI-Bro,71400966,93137,40556,52581,2022-06-12
3555,KYG Antler LLC,Influencer,Clay-Dough,16529278,93130,5281,87849,2022-07-08
4555,Meta Platforms,Media Supported Asset,Space Wars,98838402,93129,91524,1605,2022-05-29
3000,Meta Platforms,Media Supported Asset,Transmorphers,12288428,93129,40769,52360,2022-10-16
3756,Google Inc.,Media Supported Asset,Space Wars,22638232,93127,69532,23595,2022-04-05
4231,Google Inc.,Influencer,Clay-Dough,75455295,93121,54422,38699,2022-07-12
3396,TikTok Inc,Brand Asset Development,Clay-Dough,40023816,93114,45098,48016,2022-05-10
2118,Pinterest Inc,Media Supported Asset,Space Wars,44994149,93112,53342,39770,2022-07-16
4653,Disney Studios,Influencer,Merf,31965265,93097,43908,49189,2022-01-22
2280,The Martingale Agency,Brand Asset Development,Space Wars,76778456,93088,70224,22864,2022-05-29
1262,Pinterest Inc,Brand Publicity,Clay-Dough,52566244,93085,29470,63615,2022-06-25
2215,KYG Antler LLC,Media Supported Asset,Merf,53067787,93051,34563,58488,2022-10-10
2999,Nintendo Technologies,Media Supported Asset,GI-Bro,53283719,93046,14756,78290,2022-10-19
3567,Pinterest Inc,E-Commerce,GI-Bro,64410061,93004,21823,71181,2022-02-18
1834,Google Inc.,Influencer,Clay-Dough,71384346,92993,31473,61520,2022-12-17
1030,Meta Platforms,Brand Asset Development,Transmorphers,61044602,92992,42183,50809,2022-03-18
3445,Disney Studios,Brand Asset Development,GI-Bro,12557197,92991,5049,87942,2022-11-04
1434,Nintendo Technologies,Brand Asset Development,GI-Bro,93219929,92916,9530,83386,2022-12-13
3551,KYG Antler LLC,Brand Publicity,Merf,11203460,92863,66571,26292,2022-04-17
297,The Martingale Agency,Brand Asset Development,Clay-Dough,47623859,92849,4326,88523,2022-09-15
853,The Martingale Agency,Brand Asset Development,Space Wars,68435802,92838,44270,48568,2022-03-02
3759,The Martingale Agency,Brand Asset Development,GI-Bro,88016229,92825,6272,86553,2022-04-19
2733,Google Inc.,Influencer,GI-Bro,15770526,92811,51178,41633,2022-02-23
4128,Google Inc.,Influencer,GI-Bro,49845930,92808,7537,85271,2022-12-15
118,KYG Antler LLC,Brand Publicity,Space Wars,17848186,92790,42030,50760,2022-07-25
4302,Disney Studios,Brand Publicity,GI-Bro,19434236,92785,72219,20566,2022-05-09
4498,KYG Antler LLC,E-Commerce,Space Wars,55990870,92778,30367,62411,2022-03-13
3205,Meta Platforms,Brand Publicity,Merf,83439556,92716,32512,60204,2022-08-16
3461,Google Inc.,Media Supported Asset,GI-Bro,82516187,92704,40274,52430,2022-08-08
227,Pinterest Inc,Brand Asset Development,GI-Bro,93764811,92701,24106,68595,2022-02-12
2214,Pinterest Inc,E-Commerce,Clay-Dough,45643722,92668,34295,58373,2022-04-25
944,TikTok Inc,Media Supported Asset,Space Wars,33418253,92627,9064,83563,2022-02-20
4612,KYG Antler LLC,Brand Publicity,Space Wars,10083268,92588,40763,51825,2022-09-09
3748,KYG Antler LLC,Brand Asset Development,Merf,43253057,92586,788,91798,2022-08-19
4242,Nintendo Technologies,Brand Asset Development,Merf,10724831,92574,14971,77603,2022-11-15
3651,Google Inc.,Brand Publicity,Merf,31766699,92573,9028,83545,2022-10-03
4400,Google Inc.,Influencer,Merf,49013259,92567,8369,84198,2022-07-23
1321,Meta Platforms,Brand Asset Development,GI-Bro,55909336,92540,15745,76795,2022-03-23
2370,KYG Antler LLC,Brand Publicity,Transmorphers,99759658,92518,32617,59901,2022-05-07
2263,TikTok Inc,Brand Publicity,Clay-Dough,78233299,92514,89587,2927,2022-06-08
86,Google Inc.,Influencer,GI-Bro,18299124,92511,60673,31838,2022-05-19
1954,Disney Studios,E-Commerce,Transmorphers,21197052,92509,28552,63957,2022-06-18
4380,The Martingale Agency,Brand Publicity,GI-Bro,98862986,92424,11673,80751,2022-03-28
2726,Google Inc.,Brand Publicity,Merf,97729586,92408,37609,54799,2022-08-09
3779,TikTok Inc,E-Commerce,Space Wars,17194930,92377,5621,86756,2022-11-25
56,Pinterest Inc,Brand Publicity,Space Wars,61787525,92369,42946,49423,2022-08-01
1109,Google Inc.,Influencer,Merf,13435666,92355,23162,69193,2022-01-13
1130,Nintendo Technologies,Brand Asset Development,Space Wars,51087653,92282,6608,85674,2022-12-15
2148,Nintendo Technologies,Brand Asset Development,GI-Bro,58804053,92270,45638,46632,2022-07-19
1316,The Martingale Agency,E-Commerce,Clay-Dough,86268450,92257,15072,77185,2022-10-31
4444,The Martingale Agency,Brand Asset Development,GI-Bro,44066931,92240,12752,79488,2022-11-20
2727,Meta Platforms,Media Supported Asset,Transmorphers,67988559,92216,57846,34370,2022-09-08
2722,TikTok Inc,E-Commerce,Merf,26576540,92182,8032,84150,2022-11-29
3679,KYG Antler LLC,Brand Asset Development,Transmorphers,51755878,92175,17456,74719,2022-10-13
4776,Meta Platforms,Influencer,Transmorphers,94644825,92064,35378,56686,2022-08-18
251,KYG Antler LLC,E-Commerce,Clay-Dough,36919248,92038,57739,34299,2022-08-21
68,TikTok Inc,E-Commerce,Merf,73131427,92035,26093,65942,2022-12-11
1810,TikTok Inc,Media Supported Asset,GI-Bro,30704468,92017,7585,84432,2022-08-06
3999,Meta Platforms,Media Supported Asset,GI-Bro,87955967,92007,26286,65721,2022-03-12
1871,Pinterest Inc,Brand Asset Development,GI-Bro,30174593,92002,5656,86346,2022-03-29
1457,TikTok Inc,Brand Publicity,Transmorphers,66971945,91953,49624,42329,2022-07-28
4955,Disney Studios,Media Supported Asset,Transmorphers,12300509,91941,19461,72480,2022-02-03
1967,Meta Platforms,Brand Publicity,Merf,93698585,91891,86359,5532,2022-02-10
862,KYG Antler LLC,Influencer,Clay-Dough,16757490,91855,6860,84995,2022-06-15
1075,Pinterest Inc,Brand Publicity,GI-Bro,71332051,91816,56438,35378,2022-04-17
4237,The Martingale Agency,Brand Publicity,Space Wars,29763808,91814,38835,52979,2022-06-14
3357,Nintendo Technologies,Media Supported Asset,Clay-Dough,72304593,91785,74895,16890,2022-03-09
1167,Google Inc.,Brand Asset Development,GI-Bro,54285684,91783,4108,87675,2022-12-03
3638,Meta Platforms,Brand Asset Development,GI-Bro,44241711,91770,23477,68293,2022-10-23
119,The Martingale Agency,E-Commerce,Merf,49018425,91753,35935,55818,2022-08-20
2463,KYG Antler LLC,E-Commerce,Merf,70224743,91750,32655,59095,2022-10-25
1739,Nintendo Technologies,E-Commerce,Space Wars,37981909,91750,61260,30490,2022-08-15
624,Nintendo Technologies,Brand Asset Development,Merf,27970747,91717,151,91566,2022-11-30
1982,Pinterest Inc,Influencer,Clay-Dough,88858563,91666,47047,44619,2022-08-14
4496,KYG Antler LLC,Brand Publicity,Transmorphers,20841837,91626,87800,3826,2022-05-26
493,The Martingale Agency,Influencer,Space Wars,21837725,91616,1076,90540,2022-06-27
349,Disney Studios,E-Commerce,Clay-Dough,47685836,91605,32036,59569,2022-07-12
1479,The Martingale Agency,E-Commerce,GI-Bro,44589273,91579,60644,30935,2022-05-19
311,KYG Antler LLC,Brand Publicity,GI-Bro,67819539,91574,41484,50090,2022-02-06
2292,Pinterest Inc,E-Commerce,Space Wars,84804919,91558,62193,29365,2022-06-19
1622,KYG Antler LLC,E-Commerce,Space Wars,24548238,91555,82465,9090,2022-06-23
4924,KYG Antler LLC,Influencer,Space Wars,92977310,91535,11070,80465,2022-10-16
556,Google Inc.,Media Supported Asset,Clay-Dough,71870085,91507,34420,57087,2022-04-03
3137,Nintendo Technologies,E-Commerce,Clay-Dough,14584640,91475,20722,70753,2022-12-11
2066,KYG Antler LLC,E-Commerce,Space Wars,61930111,91472,10629,80843,2022-08-23
299,TikTok Inc,Brand Publicity,Clay-Dough,27403452,91432,42597,48835,2022-09-28
3745,Disney Studios,Brand Publicity,Space Wars,45604432,91425,74037,17388,2022-02-24
4446,Meta Platforms,Media Supported Asset,Transmorphers,65222012,91381,12644,78737,2022-12-16
3324,Google Inc.,Brand Publicity,Transmorphers,89087212,91365,57853,33512,2022-09-30
4845,KYG Antler LLC,Influencer,GI-Bro,94638400,91364,30338,61026,2022-10-26
4009,The Martingale Agency,Brand Asset Development,GI-Bro,39218164,91363,10324,81039,2022-10-16
691,Google Inc.,Influencer,GI-Bro,81800286,91343,8618,82725,2022-12-11
4051,Disney Studios,Brand Publicity,GI-Bro,93208567,91294,34240,57054,2022-03-20
3904,Pinterest Inc,Brand Publicity,Space Wars,96631700,91288,53028,38260,2022-02-02
4603,KYG Antler LLC,Brand Asset Development,Transmorphers,35052442,91275,26497,64778,2022-09-25
2861,Google Inc.,E-Commerce,Transmorphers,42365729,91234,59518,31716,2022-03-20
4373,Pinterest Inc,Brand Asset Development,Clay-Dough,10184402,91225,53815,37410,2022-01-08
4370,Google Inc.,Brand Asset Development,Clay-Dough,52228737,91211,87920,3291,2022-03-25
3608,Disney Studios,E-Commerce,GI-Bro,26015332,91199,173,91026,2022-11-18
3596,KYG Antler LLC,Brand Asset Development,Clay-Dough,25379586,91148,89570,1578,2022-04-13
2420,Nintendo Technologies,Brand Asset Development,Transmorphers,17488770,91136,2818,88318,2022-03-21
4307,KYG Antler LLC,Media Supported Asset,Clay-Dough,52653439,91127,7364,83763,2022-05-21
458,Google Inc.,Media Supported Asset,Clay-Dough,56258153,91098,37568,53530,2022-03-07
2497,Pinterest Inc,Media Supported Asset,Space Wars,19048981,91093,45196,45897,2022-06-18
3005,Disney Studios,Brand Asset Development,GI-Bro,51852228,91083,32707,58376,2022-03-24
1500,Google Inc.,Influencer,Merf,34808162,91043,26048,64995,2022-03-30
3442,TikTok Inc,Media Supported Asset,GI-Bro,95027615,91033,8897,82136,2022-08-26
4062,KYG Antler LLC,Brand Asset Development,Clay-Dough,93072292,91020,56229,34791,2022-02-28
4321,Disney Studios,Media Supported Asset,Merf,18551954,90994,83347,7647,2022-02-11
1218,KYG Antler LLC,Brand Asset Development,Clay-Dough,72810365,90982,25094,65888,2022-12-14
809,Disney Studios,Brand Publicity,Transmorphers,52548002,90980,2540,88440,2022-09-16
3140,TikTok Inc,Brand Publicity,Merf,33568526,90974,74135,16839,2022-06-22
2674,Nintendo Technologies,Brand Asset Development,Space Wars,62695540,90955,16011,74944,2022-11-20
4786,Meta Platforms,Brand Asset Development,Merf,31794484,90932,32598,58334,2022-01-24
176,Nintendo Technologies,Media Supported Asset,Merf,41627564,90899,57259,33640,2022-03-17
2074,Meta Platforms,Influencer,GI-Bro,26100610,90846,19332,71514,2022-11-24
3118,TikTok Inc,Influencer,GI-Bro,46080743,90821,1138,89683,2022-11-08
4264,TikTok Inc,Brand Asset Development,GI-Bro,35570883,90811,51069,39742,2022-05-15
565,The Martingale Agency,Media Supported Asset,Transmorphers,66395059,90774,33506,57268,2022-07-01
1377,The Martingale Agency,Brand Publicity,Clay-Dough,91038848,90752,87678,3074,2022-06-22
2843,TikTok Inc,Media Supported Asset,Merf,49546391,90733,35439,55294,2022-03-14
193,Meta Platforms,E-Commerce,GI-Bro,94745185,90680,48921,41759,2022-03-14
2286,KYG Antler LLC,Brand Asset Development,Space Wars,47528223,90664,72670,17994,2022-05-10
4030,Pinterest Inc,Brand Publicity,Space Wars,77614067,90633,14993,75640,2022-10-23
4995,Google Inc.,Influencer,GI-Bro,41434236,90620,24952,65668,2022-12-01
1625,Disney Studios,Influencer,Merf,85237510,90612,26066,64546,2022-01-23
2407,Nintendo Technologies,Brand Asset Development,Merf,79948376,90582,22442,68140,2022-10-05
2266,Disney Studios,Media Supported Asset,GI-Bro,86095736,90564,20504,70060,2022-04-26
2449,Google Inc.,Media Supported Asset,GI-Bro,23013757,90527,38049,52478,2022-07-08
1358,Nintendo Technologies,Brand Publicity,Transmorphers,23504045,90519,33144,57375,2022-08-17
4387,Disney Studios,E-Commerce,Clay-Dough,31353866,90507,90135,372,2022-06-21
491,Nintendo Technologies,Media Supported Asset,Transmorphers,58013030,90505,26873,63632,2022-04-21
2735,Google Inc.,Brand Asset Development,Clay-Dough,49888243,90476,53957,36519,2022-04-15
2685,The Martingale Agency,E-Commerce,Clay-Dough,55104717,90463,54035,36428,2022-03-12
4190,Pinterest Inc,Brand Publicity,Clay-Dough,93519217,90447,1887,88560,2022-08-06
1974,TikTok Inc,E-Commerce,Clay-Dough,75303371,90436,22156,68280,2022-06-25
4771,The Martingale Agency,Brand Asset Development,Merf,88237508,90390,39533,50857,2022-04-13
1354,TikTok Inc,Brand Asset Development,Transmorphers,56695724,90374,2405,87969,2022-07-21
2491,The Martingale Agency,Media Supported Asset,GI-Bro,49437142,90357,35259,55098,2022-06-15
4879,Nintendo Technologies,Brand Publicity,Merf,49094644,90318,61202,29116,2022-06-18
2860,Meta Platforms,Brand Publicity,Merf,25463989,90291,57603,32688,2022-07-03
4862,Meta Platforms,Brand Asset Development,Clay-Dough,41366618,90275,52091,38184,2022-09-23
2350,The Martingale Agency,Brand Publicity,Merf,38295218,90252,34392,55860,2022-04-29
1584,KYG Antler LLC,Media Supported Asset,GI-Bro,34469263,90228,54808,35420,2022-08-11
3529,Disney Studios,Brand Publicity,GI-Bro,79379695,90227,58181,32046,2022-02-12
2016,Disney Studios,Brand Asset Development,Transmorphers,71366297,90223,1956,88267,2022-10-25
4875,Pinterest Inc,Media Supported Asset,GI-Bro,13829249,90170,45823,44347,2022-06-14
3508,Disney Studios,Brand Publicity,Merf,43103344,90145,11713,78432,2022-10-05
4427,TikTok Inc,Media Supported Asset,Space Wars,46735651,90144,38416,51728,2022-05-31
3339,Google Inc.,Media Supported Asset,GI-Bro,32759222,90141,52441,37700,2022-02-28
335,KYG Antler LLC,Brand Asset Development,Transmorphers,50734613,90111,27813,62298,2022-11-17
874,Disney Studios,Brand Publicity,Merf,71896097,90094,51563,38531,2022-08-21
4437,The Martingale Agency,Brand Publicity,Transmorphers,22283387,90028,20668,69360,2022-03-06
631,Meta Platforms,Brand Publicity,Clay-Dough,56224088,89995,68011,21984,2022-05-05
4411,The Martingale Agency,Media Supported Asset,Space Wars,87275257,89993,57143,32850,2022-03-29
253,Disney Studios,Brand Asset Development,Transmorphers,28307942,89904,50138,39766,2022-02-28
4963,KYG Antler LLC,Brand Asset Development,GI-Bro,28884488,89872,48241,41631,2022-01-08
1253,TikTok Inc,Media Supported Asset,Clay-Dough,34121595,89865,39132,50733,2022-11-17
3918,Google Inc.,Media Supported Asset,GI-Bro,26366156,89864,38165,51699,2022-03-24
484,TikTok Inc,Brand Asset Development,GI-Bro,77932880,89864,211,89653,2022-10-14
2540,KYG Antler LLC,Brand Asset Development,Clay-Dough,69578266,89854,21499,68355,2022-06-26
3767,Meta Platforms,Media Supported Asset,Merf,15596336,89851,63406,26445,2022-03-10
4988,Meta Platforms,Media Supported Asset,Clay-Dough,17552585,89814,80205,9609,2022-05-06
2347,KYG Antler LLC,Media Supported Asset,Space Wars,31224375,89805,63006,26799,2022-04-21
2621,The Martingale Agency,E-Commerce,GI-Bro,89411504,89797,1211,88586,2022-08-10
1950,Pinterest Inc,Influencer,Merf,88713416,89716,65127,24589,2022-06-03
469,Pinterest Inc,Brand Asset Development,Transmorphers,70236329,89695,21975,67720,2022-03-16
4001,The Martingale Agency,Influencer,GI-Bro,88386370,89691,21982,67709,2022-11-29
1139,Meta Platforms,Brand Publicity,Transmorphers,94383102,89690,2107,87583,2022-10-02
1086,Pinterest Inc,Influencer,Merf,57258744,89677,59268,30409,2022-04-28
4972,The Martingale Agency,Media Supported Asset,Clay-Dough,55778679,89650,10717,78933,2022-05-25
1041,Meta Platforms,Brand Publicity,GI-Bro,76751072,89637,27898,61739,2022-12-22
1447,TikTok Inc,Media Supported Asset,Clay-Dough,77542726,89632,63709,25923,2022-05-20
125,Nintendo Technologies,Influencer,Transmorphers,19289467,89619,55566,34053,2022-08-11
2064,Nintendo Technologies,Media Supported Asset,Merf,55304614,89616,31002,58614,2022-09-23
116,The Martingale Agency,E-Commerce,Space Wars,71298000,89612,68554,21058,2022-05-24
1473,TikTok Inc,Influencer,Transmorphers,18070546,89593,18464,71129,2022-07-28
4203,Disney Studios,E-Commerce,Transmorphers,77490516,89544,35845,53699,2022-08-30
2783,The Martingale Agency,E-Commerce,Transmorphers,24182694,89513,38016,51497,2022-05-06
14,The Martingale Agency,Brand Publicity,GI-Bro,79041555,89475,17134,72341,2022-09-02
2330,KYG Antler LLC,Brand Publicity,Space Wars,41772010,89462,9946,79516,2022-08-01
1694,Nintendo Technologies,Influencer,Transmorphers,12351630,89433,32567,56866,2022-11-10
2155,Nintendo Technologies,Brand Publicity,Merf,28931032,89428,75259,14169,2022-02-03
1891,TikTok Inc,Media Supported Asset,Transmorphers,80310647,89426,60700,28726,2022-08-03
1432,TikTok Inc,E-Commerce,Space Wars,28049090,89421,38394,51027,2022-07-24
547,Disney Studios,Influencer,Space Wars,10443008,89394,7854,81540,2022-05-31
1168,Nintendo Technologies,Influencer,Transmorphers,62822711,89374,2775,86599,2022-04-28
1078,Google Inc.,Brand Publicity,GI-Bro,88706862,89364,15403,73961,2022-12-21
3547,Pinterest Inc,Brand Asset Development,Transmorphers,14091844,89331,44942,44389,2022-03-26
2078,Disney Studios,Brand Asset Development,Merf,76079870,89317,52422,36895,2022-01-04
4529,The Martingale Agency,Media Supported Asset,GI-Bro,47410820,89316,38558,50758,2022-01-24
8,KYG Antler LLC,Media Supported Asset,GI-Bro,81333642,89311,54794,34517,2022-01-23
4807,Pinterest Inc,E-Commerce,GI-Bro,17674326,89242,50623,38619,2022-07-06
2126,Google Inc.,Influencer,Transmorphers,19898217,89240,49996,39244,2022-08-16
3197,Google Inc.,Brand Publicity,Space Wars,74795776,89238,33751,55487,2022-11-17
3057,KYG Antler LLC,Influencer,GI-Bro,33715682,89232,52543,36689,2022-07-04
1943,Pinterest Inc,Brand Publicity,GI-Bro,25521559,89223,63780,25443,2022-06-28
1708,Disney Studios,Brand Publicity,Transmorphers,91462739,89195,25519,63676,2022-09-04
2803,Google Inc.,Influencer,Transmorphers,94610396,89186,48519,40667,2022-03-08
926,TikTok Inc,Brand Publicity,Space Wars,45002603,89182,35390,53792,2022-08-18
4830,The Martingale Agency,Media Supported Asset,GI-Bro,36101169,89132,5233,83899,2022-01-10
576,Google Inc.,Media Supported Asset,Clay-Dough,17392873,89117,16628,72489,2022-11-24
2623,Disney Studios,E-Commerce,GI-Bro,99288344,89105,56039,33066,2022-04-23
4953,Nintendo Technologies,Brand Publicity,GI-Bro,95305754,89075,61249,27826,2022-04-05
2396,KYG Antler LLC,Influencer,Space Wars,92931319,89070,4236,84834,2022-09-17
4582,TikTok Inc,Brand Publicity,Transmorphers,53363281,89022,24258,64764,2022-11-26
2575,Pinterest Inc,Brand Asset Development,Space Wars,45659821,89020,39140,49880,2022-08-04
2770,Meta Platforms,Media Supported Asset,Transmorphers,89908428,89013,66507,22506,2022-05-17
4011,Meta Platforms,Influencer,Merf,95478904,88970,31554,57416,2022-12-21
4882,Nintendo Technologies,Brand Publicity,GI-Bro,10783744,88961,20402,68559,2022-09-08
609,KYG Antler LLC,Brand Asset Development,Clay-Dough,47248940,88925,46033,42892,2022-04-01
2207,KYG Antler LLC,Brand Publicity,Transmorphers,57946802,88918,63060,25858,2022-07-14
2707,The Martingale Agency,Brand Asset Development,Transmorphers,76046133,88914,31722,57192,2022-06-13
3914,Disney Studios,Media Supported Asset,GI-Bro,47555792,88893,18506,70387,2022-12-02
2102,Nintendo Technologies,Brand Asset Development,GI-Bro,58158043,88886,41656,47230,2022-06-05
4164,Disney Studios,Influencer,Transmorphers,95790028,88880,86798,2082,2022-04-06
1746,Pinterest Inc,Influencer,Transmorphers,90749909,88874,69412,19462,2022-05-31
2073,Meta Platforms,Influencer,GI-Bro,63752974,88851,35871,52980,2022-10-23
2060,Nintendo Technologies,Media Supported Asset,Clay-Dough,50835861,88827,76542,12285,2022-06-14
1718,The Martingale Agency,Media Supported Asset,Clay-Dough,51055064,88791,40396,48395,2022-06-21
20,The Martingale Agency,Brand Publicity,Transmorphers,18954588,88778,26847,61931,2022-08-10
1528,Pinterest Inc,E-Commerce,Merf,74900201,88773,73060,15713,2022-03-19
2342,Google Inc.,Brand Publicity,GI-Bro,27195958,88757,21275,67482,2022-09-26
1689,Nintendo Technologies,Influencer,Space Wars,43480670,88704,56738,31966,2022-01-05
1768,Google Inc.,Media Supported Asset,Merf,55351147,88702,51805,36897,2022-04-26
2360,Meta Platforms,Brand Asset Development,Space Wars,80956070,88699,18322,70377,2022-11-06
4082,TikTok Inc,Brand Asset Development,Clay-Dough,10361782,88697,399,88298,2022-11-08
1703,Disney Studios,E-Commerce,Space Wars,46319673,88670,15398,73272,2022-12-26
1128,TikTok Inc,Brand Publicity,GI-Bro,81383315,88658,20143,68515,2022-09-28
2507,Pinterest Inc,Influencer,Clay-Dough,13880863,88619,22329,66290,2022-06-25
2450,KYG Antler LLC,Brand Publicity,Transmorphers,94645811,88575,76350,12225,2022-02-25
3239,KYG Antler LLC,Brand Asset Development,GI-Bro,94418753,88558,39615,48943,2022-08-27
4297,TikTok Inc,Media Supported Asset,GI-Bro,80824701,88528,63862,24666,2022-04-22
637,KYG Antler LLC,Brand Asset Development,Space Wars,56922996,88513,47892,40621,2022-07-16
534,The Martingale Agency,Media Supported Asset,Transmorphers,93651674,88512,63586,24926,2022-05-26
2523,TikTok Inc,Brand Publicity,Merf,71088209,88499,54264,34235,2022-07-30
3373,The Martingale Agency,Media Supported Asset,Merf,65115404,88487,4278,84209,2022-10-13
856,Disney Studios,Brand Asset Development,Space Wars,51117920,88478,15089,73389,2022-03-31
1648,The Martingale Agency,Media Supported Asset,Transmorphers,31929864,88421,24051,64370,2022-01-17
4957,The Martingale Agency,Brand Publicity,Transmorphers,53367210,88416,80546,7870,2022-02-20
2260,Pinterest Inc,Influencer,Transmorphers,24136591,88362,30428,57934,2022-12-04
824,Disney Studios,E-Commerce,Clay-Dough,68009134,88340,61840,26500,2022-05-03
3437,The Martingale Agency,E-Commerce,GI-Bro,45015086,88320,4110,84210,2022-10-01
2650,The Martingale Agency,Brand Publicity,Clay-Dough,57191074,88308,9733,78575,2022-09-25
986,Meta Platforms,Brand Asset Development,Merf,11765459,88273,2508,85765,2022-10-24
1232,KYG Antler LLC,E-Commerce,Transmorphers,32786308,88251,56455,31796,2022-06-29
3390,TikTok Inc,Media Supported Asset,Clay-Dough,77144923,88228,59437,28791,2022-03-06
2549,Disney Studios,Brand Publicity,Merf,55501274,88222,14062,74160,2022-10-29
3967,Meta Platforms,E-Commerce,GI-Bro,70908463,88193,11725,76468,2022-03-31
1263,Nintendo Technologies,Influencer,GI-Bro,46726812,88186,20290,67896,2022-07-16
28,Pinterest Inc,Brand Asset Development,Merf,69725452,88182,34273,53909,2022-11-09
1920,Nintendo Technologies,Brand Asset Development,Clay-Dough,87436117,88159,14204,73955,2022-10-25
2368,KYG Antler LLC,Media Supported Asset,Clay-Dough,25678007,88149,18745,69404,2022-12-01
3785,TikTok Inc,Influencer,Transmorphers,13842521,88145,36281,51864,2022-11-06
2465,Nintendo Technologies,E-Commerce,Transmorphers,67433694,88141,39571,48570,2022-06-28
1194,KYG Antler LLC,Brand Publicity,GI-Bro,59816520,88115,35092,53023,2022-10-02
3098,Disney Studios,Brand Publicity,Clay-Dough,39115158,88115,15395,72720,2022-10-17
452,The Martingale Agency,Brand Asset Development,Merf,24105633,88091,4658,83433,2022-10-14
4396,Nintendo Technologies,Brand Publicity,Merf,61455939,88032,55610,32422,2022-04-17
3888,The Martingale Agency,Media Supported Asset,Space Wars,70547936,88005,36752,51253,2022-05-07
919,KYG Antler LLC,E-Commerce,Merf,23086889,87990,10205,77785,2022-12-21
1730,KYG Antler LLC,Brand Asset Development,Transmorphers,27413284,87942,14101,73841,2022-07-19
1332,Google Inc.,Influencer,Clay-Dough,25914215,87906,19415,68491,2022-10-23
4213,TikTok Inc,Media Supported Asset,GI-Bro,43017570,87884,3015,84869,2022-11-14
477,Disney Studios,Media Supported Asset,GI-Bro,79935671,87880,20475,67405,2022-12-12
2579,Pinterest Inc,Influencer,GI-Bro,89986939,87875,26614,61261,2022-02-02
1483,The Martingale Agency,Influencer,Merf,75609282,87866,9872,77994,2022-06-24
3244,Pinterest Inc,Media Supported Asset,Transmorphers,80525184,87862,86614,1248,2022-04-18
4593,Google Inc.,Brand Publicity,Space Wars,41233292,87861,18967,68894,2022-03-02
4721,TikTok Inc,E-Commerce,Clay-Dough,24639052,87824,4728,83096,2022-07-26
1018,Disney Studios,Media Supported Asset,Clay-Dough,54503307,87812,22749,65063,2022-05-14
2997,Pinterest Inc,E-Commerce,Transmorphers,61896461,87812,35546,52266,2022-05-01
3131,Meta Platforms,Brand Asset Development,Space Wars,61640560,87784,32919,54865,2022-04-21
1369,KYG Antler LLC,Media Supported Asset,GI-Bro,51265393,87754,31847,55907,2022-10-19
3526,KYG Antler LLC,Media Supported Asset,GI-Bro,55747107,87723,35153,52570,2022-07-11
3807,Nintendo Technologies,Brand Publicity,GI-Bro,60478691,87682,16037,71645,2022-02-15
170,Disney Studios,Influencer,GI-Bro,42043721,87676,25125,62551,2022-07-28
4870,Pinterest Inc,Media Supported Asset,Merf,53014654,87675,24947,62728,2022-10-15
3213,Pinterest Inc,Media Supported Asset,Merf,36416486,87673,39833,47840,2022-09-23
3058,Disney Studios,Brand Publicity,GI-Bro,57279654,87661,6261,81400,2022-10-11
23,KYG Antler LLC,Brand Asset Development,Clay-Dough,83449785,87650,16653,70997,2022-11-11
3612,Google Inc.,Media Supported Asset,Transmorphers,15364108,87647,58474,29173,2022-02-13
4538,Pinterest Inc,Influencer,Space Wars,13199671,87640,35365,52275,2022-11-30
1202,TikTok Inc,Brand Asset Development,Transmorphers,85581542,87633,83469,4164,2022-02-25
3145,KYG Antler LLC,Influencer,Space Wars,48576368,87628,73566,14062,2022-03-22
2473,Nintendo Technologies,Brand Asset Development,GI-Bro,21497477,87621,62034,25587,2022-03-15
838,Meta Platforms,E-Commerce,Merf,33474916,87611,28561,59050,2022-12-15
2835,The Martingale Agency,Media Supported Asset,Clay-Dough,66872086,87608,15319,72289,2022-08-10
1362,Pinterest Inc,Media Supported Asset,GI-Bro,71292167,87606,4649,82957,2022-05-31
4204,Meta Platforms,E-Commerce,Space Wars,41167408,87596,67509,20087,2022-04-05
3306,Meta Platforms,Media Supported Asset,Clay-Dough,83116066,87589,52089,35500,2022-02-22
2686,KYG Antler LLC,Media Supported Asset,Merf,84983943,87568,36627,50941,2022-01-19
3269,KYG Antler LLC,E-Commerce,Clay-Dough,77481526,87533,4034,83499,2022-08-02
1915,TikTok Inc,Influencer,Clay-Dough,18440245,87519,23555,63964,2022-11-08
3214,Pinterest Inc,Media Supported Asset,Merf,78755145,87506,77898,9608,2022-06-07
1423,Meta Platforms,Media Supported Asset,Space Wars,78784799,87505,19005,68500,2022-12-27
3100,Google Inc.,Brand Publicity,GI-Bro,40963549,87504,61290,26214,2022-01-29
3863,Meta Platforms,Brand Publicity,GI-Bro,52895788,87476,60132,27344,2022-08-05
365,KYG Antler LLC,Brand Publicity,Merf,78941379,87438,4415,83023,2022-07-20
4473,KYG Antler LLC,Influencer,Clay-Dough,67635521,87361,58417,28944,2022-07-05
964,Disney Studios,E-Commerce,Merf,38002409,87353,9135,78218,2022-12-02
1616,The Martingale Agency,Brand Asset Development,GI-Bro,49384200,87352,50539,36813,2022-07-04
4889,Pinterest Inc,Media Supported Asset,GI-Bro,27206688,87349,1326,86023,2022-04-24
181,Pinterest Inc,Brand Publicity,GI-Bro,34845989,87336,14994,72342,2022-07-07
4407,The Martingale Agency,Brand Asset Development,Space Wars,31570817,87333,77676,9657,2022-03-17
4999,The Martingale Agency,Brand Publicity,Transmorphers,17377491,87323,72094,15229,2022-01-18
1933,Google Inc.,E-Commerce,Transmorphers,56917388,87284,39321,47963,2022-05-21
2018,Disney Studios,Media Supported Asset,Transmorphers,41979604,87270,29731,57539,2022-11-28
3310,Pinterest Inc,E-Commerce,GI-Bro,21567716,87257,15989,71268,2022-06-18
481,The Martingale Agency,Influencer,Transmorphers,93043918,87241,58456,28785,2022-09-11
2825,Nintendo Technologies,Media Supported Asset,Merf,69287348,87209,3657,83552,2022-06-20
1116,TikTok Inc,Influencer,Merf,90183757,87133,37853,49280,2022-04-07
3621,Meta Platforms,Influencer,Clay-Dough,10341721,87101,24821,62280,2022-08-01
4233,Meta Platforms,E-Commerce,Merf,11929476,87098,50805,36293,2022-01-03
4747,KYG Antler LLC,Media Supported Asset,Merf,88396773,87094,84063,3031,2022-02-20
2576,TikTok Inc,Influencer,GI-Bro,49130191,87090,13027,74063,2022-09-22
4667,Nintendo Technologies,Media Supported Asset,Merf,19492024,87081,48315,38766,2022-09-18
1239,Disney Studios,Brand Publicity,GI-Bro,13303979,87068,6864,80204,2022-06-14
2284,TikTok Inc,Media Supported Asset,Merf,14802270,87053,25996,61057,2022-12-14
4099,TikTok Inc,Media Supported Asset,Space Wars,67951008,87048,14365,72683,2022-08-17
2195,Nintendo Technologies,Influencer,Clay-Dough,77046468,87044,49346,37698,2022-08-31
2607,The Martingale Agency,E-Commerce,GI-Bro,58653518,86996,29575,57421,2022-10-15
401,The Martingale Agency,Brand Publicity,Space Wars,93648452,86987,13828,73159,2022-03-03
3312,KYG Antler LLC,Brand Asset Development,GI-Bro,38471469,86970,3342,83628,2022-11-07
4015,Pinterest Inc,Influencer,GI-Bro,12085401,86930,32006,54924,2022-04-13
2591,Disney Studios,E-Commerce,Transmorphers,73902262,86926,12921,74005,2022-09-05
1661,Nintendo Technologies,Media Supported Asset,Transmorphers,45831731,86914,5385,81529,2022-10-24
3077,Disney Studios,Influencer,Merf,60175784,86848,13678,73170,2022-12-15
4247,The Martingale Agency,Brand Publicity,GI-Bro,80064271,86830,8963,77867,2022-10-16
994,Meta Platforms,Influencer,Clay-Dough,39730897,86801,16821,69980,2022-10-23
2236,Meta Platforms,E-Commerce,Clay-Dough,54334860,86770,51236,35534,2022-09-09
2003,KYG Antler LLC,Influencer,GI-Bro,36608528,86767,31485,55282,2022-10-16
872,Disney Studios,Brand Asset Development,Clay-Dough,93153793,86762,75988,10774,2022-01-04
3350,Meta Platforms,Brand Publicity,Clay-Dough,53722339,86751,18866,67885,2022-02-05
1977,Meta Platforms,Media Supported Asset,Merf,77710741,86714,74951,11763,2022-06-13
425,Nintendo Technologies,Brand Publicity,Space Wars,23002798,86684,60615,26069,2022-03-23
2512,Disney Studios,Media Supported Asset,Transmorphers,20528650,86682,11728,74954,2022-03-01
1612,Pinterest Inc,Brand Publicity,Transmorphers,24204296,86667,79610,7057,2022-03-06
374,The Martingale Agency,Brand Asset Development,Space Wars,51114623,86620,56973,29647,2022-04-03
4905,Disney Studios,E-Commerce,GI-Bro,60528170,86613,61828,24785,2022-04-25
613,KYG Antler LLC,E-Commerce,Space Wars,64370693,86611,4816,81795,2022-12-04
4860,Google Inc.,Media Supported Asset,Transmorphers,21818074,86596,80975,5621,2022-04-04
3236,TikTok Inc,Media Supported Asset,Space Wars,68289515,86568,61992,24576,2022-01-11
3459,Pinterest Inc,Brand Publicity,Space Wars,82406467,86556,56865,29691,2022-07-07
630,Google Inc.,Influencer,GI-Bro,90232493,86489,54724,31765,2022-09-03
381,Nintendo Technologies,Brand Publicity,Clay-Dough,73270424,86461,9072,77389,2022-10-05
2982,Nintendo Technologies,Influencer,Merf,53860597,86430,22310,64120,2022-09-27
3466,Nintendo Technologies,Brand Asset Development,Clay-Dough,60524024,86392,46792,39600,2022-07-06
1607,Disney Studios,E-Commerce,Space Wars,36933482,86384,8980,77404,2022-11-12
2836,Pinterest Inc,E-Commerce,Space Wars,53329139,86378,454,85924,2022-01-20
3262,Disney Studios,Media Supported Asset,Merf,88336502,86362,29142,57220,2022-02-18
2602,TikTok Inc,E-Commerce,GI-Bro,27593228,86333,56440,29893,2022-07-22
3783,The Martingale Agency,Media Supported Asset,GI-Bro,87951073,86329,5503,80826,2022-01-27
239,TikTok Inc,E-Commerce,Space Wars,85109872,86319,59728,26591,2022-08-30
1934,KYG Antler LLC,E-Commerce,Transmorphers,85338199,86314,17400,68914,2022-10-22
3909,TikTok Inc,Brand Asset Development,Space Wars,66571557,86295,29073,57222,2022-05-29
2797,The Martingale Agency,Media Supported Asset,Space Wars,96886924,86263,81483,4780,2022-06-09
4169,Pinterest Inc,Influencer,Clay-Dough,47429305,86256,19466,66790,2022-12-14
1269,Google Inc.,Brand Asset Development,Clay-Dough,51367525,86244,33852,52392,2022-12-26
207,Disney Studios,E-Commerce,Clay-Dough,61340280,86229,53707,32522,2022-07-11
1438,TikTok Inc,Brand Asset Development,Clay-Dough,10515366,86228,2232,83996,2022-08-15
2201,Nintendo Technologies,Brand Asset Development,GI-Bro,17094324,86227,15826,70401,2022-08-05
4531,The Martingale Agency,E-Commerce,Merf,27744423,86196,25725,60471,2022-09-09
2031,Meta Platforms,Brand Publicity,Space Wars,38726792,86183,17910,68273,2022-10-04
1426,Disney Studios,Brand Publicity,Clay-Dough,97630907,86162,40114,46048,2022-07-09
4074,Disney Studios,Brand Publicity,Space Wars,14052871,86157,48936,37221,2022-02-10
3047,KYG Antler LLC,E-Commerce,Clay-Dough,25539261,86155,13072,73083,2022-11-03
159,Nintendo Technologies,Influencer,Space Wars,64376189,86143,71043,15100,2022-06-22
2007,TikTok Inc,Brand Publicity,Clay-Dough,26008525,86141,2046,84095,2022-01-26
4929,KYG Antler LLC,Brand Asset Development,Space Wars,74729859,86112,17769,68343,2022-06-11
4036,TikTok Inc,Brand Asset Development,Merf,50604870,86078,27610,58468,2022-08-17
538,TikTok Inc,Media Supported Asset,GI-Bro,16594695,86061,3489,82572,2022-09-05
617,KYG Antler LLC,Brand Publicity,GI-Bro,65242424,86042,5392,80650,2022-01-15
4317,The Martingale Agency,Brand Asset Development,GI-Bro,63972989,85964,66699,19265,2022-05-09
3670,Nintendo Technologies,Influencer,Space Wars,18537706,85940,33417,52523,2022-11-23
949,Disney Studios,Influencer,Space Wars,98649725,85932,81227,4705,2022-02-20
3257,Meta Platforms,Media Supported Asset,Space Wars,88755301,85905,4491,81414,2022-12-15
1640,Nintendo Technologies,E-Commerce,Merf,88726650,85885,19675,66210,2022-11-23
1347,Google Inc.,Media Supported Asset,Transmorphers,38516978,85884,85401,483,2022-06-26
2188,The Martingale Agency,Brand Asset Development,Clay-Dough,73134271,85880,54626,31254,2022-08-22
4117,TikTok Inc,Brand Asset Development,Space Wars,26081621,85876,18045,67831,2022-01-14
1570,Google Inc.,Media Supported Asset,GI-Bro,74336219,85876,23938,61938,2022-08-08
3553,Google Inc.,Brand Publicity,Space Wars,40513726,85840,44142,41698,2022-04-05
1126,KYG Antler LLC,Brand Publicity,Space Wars,88681818,85821,16701,69120,2022-10-26
102,Google Inc.,Media Supported Asset,Clay-Dough,47423387,85764,21370,64394,2022-01-02
427,Meta Platforms,Brand Publicity,Merf,27358027,85728,16526,69202,2022-06-03
1190,The Martingale Agency,Brand Asset Development,Space Wars,61416844,85715,2869,82846,2022-11-12
1257,The Martingale Agency,Brand Asset Development,Merf,31475270,85660,22202,63458,2022-04-20
4065,Nintendo Technologies,E-Commerce,GI-Bro,37175979,85649,32108,53541,2022-07-23
3736,Meta Platforms,Brand Asset Development,Clay-Dough,80770278,85645,17370,68275,2022-10-12
1639,Nintendo Technologies,Brand Publicity,Merf,38269118,85619,23488,62131,2022-10-16
2756,Pinterest Inc,Influencer,Transmorphers,16866733,85613,13420,72193,2022-12-03
2666,Nintendo Technologies,Influencer,GI-Bro,57563095,85542,43167,42375,2022-09-25
2881,Nintendo Technologies,Brand Publicity,Transmorphers,41400445,85485,59007,26478,2022-07-26
3691,Disney Studios,Brand Publicity,Space Wars,24958411,85461,27238,58223,2022-04-15
1346,TikTok Inc,Brand Asset Development,Merf,37721991,85395,20028,65367,2022-03-18
4937,Meta Platforms,E-Commerce,Space Wars,20733196,85364,73972,11392,2022-02-13
1636,KYG Antler LLC,Media Supported Asset,GI-Bro,42804912,85335,32090,53245,2022-03-22
2383,Google Inc.,E-Commerce,GI-Bro,53943128,85309,66075,19234,2022-01-31
179,The Martingale Agency,Influencer,Clay-Dough,74970568,85277,77893,7384,2022-03-31
3845,Google Inc.,E-Commerce,Transmorphers,49613285,85270,66967,18303,2022-05-28
1024,TikTok Inc,Brand Publicity,Clay-Dough,33542934,85258,58408,26850,2022-08-21
568,Disney Studios,Influencer,Clay-Dough,36628911,85249,15770,69479,2022-08-18
1733,Google Inc.,Brand Publicity,Transmorphers,48227522,85235,40937,44298,2022-06-16
3633,Nintendo Technologies,E-Commerce,GI-Bro,83559318,85228,63219,22009,2022-04-14
2818,Pinterest Inc,Brand Publicity,Clay-Dough,86864247,85209,45775,39434,2022-01-23
3729,Disney Studios,Influencer,Transmorphers,18750341,85191,45891,39300,2022-01-23
3380,Meta Platforms,Influencer,Merf,78562153,85183,27778,57405,2022-01-16
3975,Pinterest Inc,Brand Asset Development,Space Wars,92371621,85178,77607,7571,2022-02-02
3457,The Martingale Agency,Influencer,Transmorphers,34668967,85171,72338,12833,2022-02-11
3029,TikTok Inc,E-Commerce,Clay-Dough,50774065,85168,74900,10268,2022-04-25
2163,TikTok Inc,Brand Publicity,Transmorphers,73995616,85157,11373,73784,2022-09-28
710,Disney Studios,Media Supported Asset,Transmorphers,98264016,85156,70462,14694,2022-06-23
4920,Disney Studios,Influencer,GI-Bro,10318423,85095,16229,68866,2022-12-26
4682,KYG Antler LLC,Brand Asset Development,Merf,44619967,85090,45358,39732,2022-09-09
4785,Nintendo Technologies,E-Commerce,GI-Bro,57907275,85029,17565,67464,2022-07-15
2477,Google Inc.,Influencer,Clay-Dough,95986026,85026,76089,8937,2022-06-17
1795,KYG Antler LLC,Influencer,Space Wars,10014443,85018,76117,8901,2022-02-22
3963,The Martingale Agency,E-Commerce,Clay-Dough,81608368,85011,13632,71379,2022-07-04
1545,KYG Antler LLC,E-Commerce,Merf,39725641,84944,16886,68058,2022-06-11
812,The Martingale Agency,Brand Asset Development,GI-Bro,29959243,84933,23785,61148,2022-07-25
2903,KYG Antler LLC,Influencer,Space Wars,18124660,84924,19989,64935,2022-10-30
3192,Meta Platforms,Influencer,Transmorphers,45111904,84901,30805,54096,2022-11-02
180,TikTok Inc,Brand Publicity,Space Wars,16587758,84898,52602,32296,2022-06-25
3544,Nintendo Technologies,Brand Asset Development,Merf,19776198,84864,28867,55997,2022-01-16
3408,The Martingale Agency,Brand Publicity,Transmorphers,42922410,84846,39240,45606,2022-08-12
993,Disney Studios,E-Commerce,Transmorphers,69247242,84840,61403,23437,2022-05-30
3591,Disney Studios,Brand Publicity,Transmorphers,18885503,84840,40259,44581,2022-09-03
29,Meta Platforms,E-Commerce,GI-Bro,92152277,84839,58161,26678,2022-08-13
1013,Meta Platforms,Brand Publicity,Space Wars,26333691,84805,49741,35064,2022-01-11
2139,KYG Antler LLC,Media Supported Asset,Transmorphers,74867325,84782,80407,4375,2022-02-10
101,Google Inc.,Media Supported Asset,Transmorphers,95370390,84776,15509,69267,2022-01-05
282,TikTok Inc,Media Supported Asset,Merf,67634392,84764,12982,71782,2022-08-23
3956,Google Inc.,Brand Asset Development,Transmorphers,10337039,84745,54015,30730,2022-04-20
632,The Martingale Agency,Media Supported Asset,GI-Bro,42294480,84713,23716,60997,2022-01-28
2552,Pinterest Inc,Brand Publicity,GI-Bro,38970576,84689,9256,75433,2022-12-11
3410,KYG Antler LLC,Brand Publicity,GI-Bro,70211882,84639,2860,81779,2022-01-09
4457,Google Inc.,Brand Publicity,GI-Bro,46096931,84615,23105,61510,2022-10-15
1400,Pinterest Inc,Media Supported Asset,GI-Bro,69521610,84594,30384,54210,2022-10-29
2890,Pinterest Inc,Influencer,GI-Bro,99649387,84591,17262,67329,2022-08-31
2608,Pinterest Inc,Brand Publicity,Transmorphers,56194949,84568,49982,34586,2022-07-01
744,Meta Platforms,Influencer,Clay-Dough,32298435,84557,39499,45058,2022-02-24
1944,Nintendo Technologies,E-Commerce,Transmorphers,97981163,84500,19799,64701,2022-11-24
4361,Disney Studios,Brand Asset Development,GI-Bro,17590148,84470,12585,71885,2022-11-05
3419,Meta Platforms,Influencer,GI-Bro,16290684,84438,81733,2705,2022-06-16
3645,The Martingale Agency,E-Commerce,Clay-Dough,39073848,84365,26734,57631,2022-12-01
3258,Disney Studios,Media Supported Asset,Clay-Dough,50394514,84363,62885,21478,2022-03-28
1177,Meta Platforms,Media Supported Asset,Transmorphers,69632507,84341,21286,63055,2022-11-01
866,Disney Studios,Media Supported Asset,GI-Bro,10442028,84316,19777,64539,2022-12-10
3493,Google Inc.,Brand Publicity,Clay-Dough,53156938,84298,14281,70017,2022-01-25
210,Google Inc.,Influencer,Merf,50725998,84296,12694,71602,2022-07-15
232,The Martingale Agency,Brand Asset Development,Clay-Dough,39641090,84276,12326,71950,2022-10-22
4686,Meta Platforms,E-Commerce,GI-Bro,47074508,84274,75599,8675,2022-03-21
1554,The Martingale Agency,E-Commerce,Transmorphers,33206804,84246,6750,77496,2022-01-07
767,Nintendo Technologies,Brand Publicity,Merf,97253099,84238,46207,38031,2022-01-08
1665,Google Inc.,E-Commerce,Transmorphers,23866520,84187,18606,65581,2022-12-06
4868,The Martingale Agency,E-Commerce,Merf,92935191,84186,11567,72619,2022-01-19
3446,Meta Platforms,Influencer,Merf,63587207,84175,1401,82774,2022-04-21
1204,TikTok Inc,Influencer,Clay-Dough,19647629,84134,29460,54674,2022-08-30
1084,KYG Antler LLC,E-Commerce,Space Wars,30016922,84078,50778,33300,2022-07-20
1512,The Martingale Agency,Brand Publicity,Transmorphers,49315977,84069,83074,995,2022-04-09
829,Nintendo Technologies,E-Commerce,Transmorphers,44785416,84043,82698,1345,2022-05-06
3620,Disney Studios,Brand Asset Development,Space Wars,14714639,84004,15869,68135,2022-09-15
2086,KYG Antler LLC,Influencer,GI-Bro,46074377,83991,38070,45921,2022-07-14
2259,TikTok Inc,E-Commerce,Merf,45824396,83981,32681,51300,2022-06-19
4708,Pinterest Inc,Brand Publicity,GI-Bro,75540456,83957,75743,8214,2022-02-05
4986,KYG Antler LLC,E-Commerce,GI-Bro,56943768,83897,20597,63300,2022-12-28
584,Disney Studios,Influencer,Transmorphers,57522998,83876,78351,5525,2022-02-08
1113,Meta Platforms,Influencer,Space Wars,34782182,83867,19679,64188,2022-07-31
331,Meta Platforms,Brand Asset Development,Transmorphers,33981300,83857,26472,57385,2022-10-26
3173,Meta Platforms,Media Supported Asset,Clay-Dough,29352818,83856,27116,56740,2022-09-12
4668,TikTok Inc,Brand Asset Development,Merf,64367212,83838,65984,17854,2022-06-13
977,Google Inc.,E-Commerce,Transmorphers,80824728,83820,14867,68953,2022-07-12
3159,Pinterest Inc,Brand Asset Development,Clay-Dough,52946587,83803,12450,71353,2022-12-21
3765,Google Inc.,E-Commerce,GI-Bro,81211256,83798,25382,58416,2022-11-09
735,The Martingale Agency,Influencer,GI-Bro,75094154,83764,51246,32518,2022-06-22
2678,Disney Studios,Media Supported Asset,GI-Bro,81738621,83755,53027,30728,2022-06-18
42,KYG Antler LLC,Brand Asset Development,Space Wars,21232578,83750,54499,29251,2022-05-30
3210,Nintendo Technologies,Media Supported Asset,Transmorphers,67313416,83713,34431,49282,2022-07-14
1071,Meta Platforms,Media Supported Asset,Clay-Dough,19585002,83700,11291,72409,2022-03-15
3296,TikTok Inc,Influencer,Transmorphers,69779721,83666,54852,28814,2022-09-20
1840,Meta Platforms,Influencer,Clay-Dough,97811040,83638,58069,25569,2022-03-30
3283,Meta Platforms,Influencer,Space Wars,10037596,83635,6011,77624,2022-06-04
4594,KYG Antler LLC,Brand Asset Development,Space Wars,79985744,83633,33887,49746,2022-08-13
12,The Martingale Agency,Brand Asset Development,GI-Bro,56732357,83633,3100,80533,2022-12-07
1510,Pinterest Inc,Influencer,Transmorphers,96917944,83618,11821,71797,2022-09-25
2984,Google Inc.,Influencer,Merf,27667940,83618,53958,29660,2022-04-23
4166,Google Inc.,Brand Publicity,GI-Bro,51439626,83608,6876,76732,2022-10-17
2910,Nintendo Technologies,Brand Publicity,Transmorphers,71056705,83606,17413,66193,2022-02-07
2897,The Martingale Agency,Brand Asset Development,GI-Bro,93619648,83605,17631,65974,2022-10-11
1842,Pinterest Inc,Media Supported Asset,Merf,11005113,83602,72332,11270,2022-02-15
334,Disney Studios,Influencer,Space Wars,36319735,83587,69636,13951,2022-01-05
801,Google Inc.,E-Commerce,Clay-Dough,26916788,83546,27617,55929,2022-11-24
1064,Meta Platforms,Brand Asset Development,Merf,86215159,83546,2070,81476,2022-03-27
2633,Google Inc.,Brand Publicity,Transmorphers,67519755,83540,613,82927,2022-01-09
3013,Disney Studios,Media Supported Asset,Transmorphers,85410178,83512,28297,55215,2022-10-05
743,Meta Platforms,Influencer,Clay-Dough,72098113,83510,46088,37422,2022-03-27
3365,Nintendo Technologies,Media Supported Asset,Clay-Dough,44174775,83474,11945,71529,2022-07-25
3891,Meta Platforms,Influencer,GI-Bro,18494185,83441,25549,57892,2022-12-23
1559,Pinterest Inc,Brand Asset Development,Merf,25770017,83416,64731,18685,2022-03-16
2107,The Martingale Agency,Brand Publicity,Transmorphers,29857507,83415,37593,45822,2022-07-21
1638,TikTok Inc,Influencer,GI-Bro,90741171,83413,45773,37640,2022-01-20
2760,KYG Antler LLC,E-Commerce,Space Wars,26221370,83409,10654,72755,2022-11-02
2499,Nintendo Technologies,Influencer,Clay-Dough,59477010,83404,47477,35927,2022-05-13
3554,KYG Antler LLC,Brand Asset Development,Transmorphers,30996142,83370,2710,80660,2022-05-25
975,Pinterest Inc,E-Commerce,GI-Bro,82569166,83349,19627,63722,2022-11-18
4775,KYG Antler LLC,Influencer,Space Wars,82893401,83336,14613,68723,2022-12-25
2410,Disney Studios,Brand Asset Development,Clay-Dough,32837990,83330,82542,788,2022-06-11
1312,TikTok Inc,Brand Publicity,Merf,57317407,83310,30464,52846,2022-07-08
3754,Meta Platforms,E-Commerce,Clay-Dough,10480313,83309,18986,64323,2022-10-15
4554,Disney Studios,Media Supported Asset,Transmorphers,87508121,83306,5548,77758,2022-02-18
2104,KYG Antler LLC,Brand Asset Development,Transmorphers,33958483,83305,79100,4205,2022-05-08
412,Disney Studios,Influencer,Clay-Dough,66054005,83297,60219,23078,2022-01-04
2822,Meta Platforms,Brand Asset Development,Merf,28474723,83290,21300,61990,2022-12-13
4516,Nintendo Technologies,Brand Publicity,Space Wars,22669408,83285,49341,33944,2022-01-29
2969,TikTok Inc,Media Supported Asset,Transmorphers,19179171,83264,27566,55698,2022-11-17
2072,The Martingale Agency,Brand Publicity,Transmorphers,31506612,83263,35155,48108,2022-07-14
2542,Nintendo Technologies,Brand Asset Development,Transmorphers,16552146,83260,22813,60447,2022-11-06
2224,The Martingale Agency,Brand Publicity,Merf,28091828,83259,48862,34397,2022-08-19
3072,Disney Studios,Media Supported Asset,GI-Bro,63445686,83259,11389,71870,2022-12-05
2772,Meta Platforms,E-Commerce,Merf,80130517,83230,26868,56362,2022-11-10
3427,Meta Platforms,Influencer,Transmorphers,16885735,83206,28227,54979,2022-02-19
859,TikTok Inc,Influencer,Space Wars,81986730,83198,47865,35333,2022-04-14
3037,TikTok Inc,Brand Publicity,GI-Bro,63433280,83179,56785,26394,2022-08-27
3215,Nintendo Technologies,Influencer,GI-Bro,33177333,83161,40682,42479,2022-08-26
3247,Nintendo Technologies,Brand Publicity,Merf,78598002,83148,39236,43912,2022-05-21
1267,TikTok Inc,Brand Asset Development,Space Wars,45933745,83112,20922,62190,2022-07-11
4474,The Martingale Agency,Media Supported Asset,Merf,87020349,83096,1903,81193,2022-01-26
122,Disney Studios,E-Commerce,Clay-Dough,86994252,83046,29281,53765,2022-09-07
3784,Nintendo Technologies,Media Supported Asset,Clay-Dough,65760108,83028,20716,62312,2022-07-01
3720,Meta Platforms,Brand Asset Development,Space Wars,90299084,83014,29401,53613,2022-11-01
747,Pinterest Inc,E-Commerce,Space Wars,29928655,82979,32089,50890,2022-10-26
1598,Disney Studios,Influencer,Merf,75906287,82953,52420,30533,2022-06-05
1227,Pinterest Inc,E-Commerce,GI-Bro,23793169,82949,3297,79652,2022-05-30
559,Disney Studios,Brand Publicity,GI-Bro,29152115,82948,34845,48103,2022-05-21
1203,KYG Antler LLC,Media Supported Asset,Space Wars,11870262,82942,21405,61537,2022-06-28
3682,Disney Studios,E-Commerce,Merf,76968831,82934,45959,36975,2022-07-15
4626,Nintendo Technologies,Brand Publicity,Space Wars,38959266,82931,9325,73606,2022-10-08
126,Nintendo Technologies,E-Commerce,Transmorphers,67286338,82916,59549,23367,2022-01-10
2495,TikTok Inc,Brand Asset Development,Transmorphers,86925607,82839,33275,49564,2022-08-12
3510,Nintendo Technologies,E-Commerce,Space Wars,25359518,82838,24835,58003,2022-03-18
2249,Meta Platforms,E-Commerce,GI-Bro,49891099,82822,31931,50891,2022-12-22
4050,Meta Platforms,Brand Asset Development,Transmorphers,50244123,82817,3845,78972,2022-10-25
4560,The Martingale Agency,Media Supported Asset,Clay-Dough,16669203,82816,67797,15019,2022-06-12
4441,KYG Antler LLC,E-Commerce,Merf,76159845,82752,20796,61956,2022-11-20
3082,Nintendo Technologies,Influencer,Clay-Dough,72987290,82745,16286,66459,2022-11-13
1773,Nintendo Technologies,Brand Publicity,Clay-Dough,73839354,82705,34290,48415,2022-03-16
3821,Nintendo Technologies,Brand Asset Development,Clay-Dough,47256314,82669,20376,62293,2022-08-07
679,Meta Platforms,Influencer,Space Wars,72213346,82665,63797,18868,2022-03-21
131,Pinterest Inc,Brand Asset Development,GI-Bro,37349655,82659,21525,61134,2022-01-13
629,Meta Platforms,E-Commerce,Space Wars,98546461,82648,6259,76389,2022-10-29
1595,Pinterest Inc,Media Supported Asset,Clay-Dough,79722977,82644,990,81654,2022-10-08
4482,The Martingale Agency,Brand Publicity,GI-Bro,33581261,82628,11499,71129,2022-04-04
2985,Meta Platforms,Media Supported Asset,GI-Bro,55832673,82606,35921,46685,2022-08-03
81,Pinterest Inc,Influencer,Transmorphers,28748162,82596,28657,53939,2022-01-02
3467,The Martingale Agency,E-Commerce,GI-Bro,19709740,82548,62195,20353,2022-03-19
1211,Nintendo Technologies,Brand Asset Development,Transmorphers,75431307,82499,31301,51198,2022-10-11
1674,KYG Antler LLC,Brand Publicity,Clay-Dough,52313580,82489,9114,73375,2022-11-26
989,Meta Platforms,Brand Publicity,Transmorphers,59247422,82452,29426,53026,2022-09-28
3455,The Martingale Agency,Influencer,Clay-Dough,40635735,82382,16370,66012,2022-10-31
3721,Google Inc.,Brand Publicity,Space Wars,23815325,82365,71908,10457,2022-04-12
4939,Disney Studios,E-Commerce,Clay-Dough,26361346,82354,21406,60948,2022-06-03
4022,Pinterest Inc,Media Supported Asset,Transmorphers,39431723,82309,53320,28989,2022-04-16
4314,KYG Antler LLC,Brand Publicity,Merf,61396759,82308,9891,72417,2022-11-17
2740,Google Inc.,Brand Asset Development,Clay-Dough,77784066,82307,19667,62640,2022-08-13
3969,Nintendo Technologies,Brand Asset Development,Space Wars,91838474,82290,59155,23135,2022-05-17
2024,KYG Antler LLC,Media Supported Asset,GI-Bro,47527155,82274,19934,62340,2022-10-02
2794,Nintendo Technologies,Influencer,Space Wars,93024738,82206,3647,78559,2022-10-01
222,Disney Studios,Media Supported Asset,GI-Bro,30421525,82198,18346,63852,2022-02-23
2379,TikTok Inc,Influencer,Clay-Dough,98438691,82191,40625,41566,2022-05-12
1241,KYG Antler LLC,Media Supported Asset,Clay-Dough,42841142,82183,22231,59952,2022-05-12
1563,The Martingale Agency,Brand Publicity,Transmorphers,64236195,82182,25446,56736,2022-07-12
3566,Meta Platforms,Brand Asset Development,Merf,78046815,82137,5941,76196,2022-11-29
41,Disney Studios,Media Supported Asset,Space Wars,78643287,82135,36065,46070,2022-08-23
3161,Meta Platforms,Brand Publicity,Transmorphers,80394470,82133,70961,11172,2022-04-01
522,Nintendo Technologies,Brand Asset Development,Space Wars,84856049,82075,6670,75405,2022-10-12
3843,Nintendo Technologies,Brand Asset Development,Transmorphers,34705110,82073,52320,29753,2022-09-14
4137,Nintendo Technologies,Media Supported Asset,Merf,35528199,82068,66409,15659,2022-02-15
2629,TikTok Inc,Influencer,Transmorphers,77151559,82047,39880,42167,2022-03-15
1879,KYG Antler LLC,E-Commerce,Transmorphers,97537144,82013,28490,53523,2022-10-05
4159,TikTok Inc,Brand Asset Development,Space Wars,82867928,82003,61344,20659,2022-02-07
2493,TikTok Inc,Influencer,Merf,36076777,82001,25828,56173,2022-01-04
688,TikTok Inc,Brand Publicity,Merf,59041192,81997,22798,59199,2022-11-18
4422,The Martingale Agency,Brand Asset Development,Merf,64059384,81968,847,81121,2022-06-13
2096,The Martingale Agency,E-Commerce,Transmorphers,31704240,81966,23940,58026,2022-11-30
92,Disney Studios,E-Commerce,GI-Bro,87231139,81939,25548,56391,2022-04-29
4744,KYG Antler LLC,Brand Publicity,GI-Bro,70863825,81935,66810,15125,2022-03-29
3623,Nintendo Technologies,Media Supported Asset,Transmorphers,67703074,81934,1812,80122,2022-12-02
2308,Meta Platforms,Influencer,Merf,26343757,81930,26984,54946,2022-08-08
1261,Disney Studios,Brand Publicity,Space Wars,11885610,81868,57079,24789,2022-02-09
4973,Nintendo Technologies,Media Supported Asset,Merf,28288528,81868,44032,37836,2022-02-26
4027,TikTok Inc,Influencer,Transmorphers,80843519,81843,50137,31706,2022-02-10
2720,The Martingale Agency,Brand Asset Development,GI-Bro,63053262,81835,9990,71845,2022-01-17
31,Disney Studios,Influencer,Clay-Dough,98966997,81786,23353,58433,2022-12-25
982,Google Inc.,E-Commerce,Clay-Dough,71463861,81762,26738,55024,2022-01-24
1594,Pinterest Inc,Media Supported Asset,GI-Bro,93409222,81751,9505,72246,2022-11-29
3361,Pinterest Inc,E-Commerce,Transmorphers,75232525,81732,1126,80606,2022-07-05
1769,Nintendo Technologies,Influencer,Space Wars,93578937,81704,22907,58797,2022-03-25
1124,TikTok Inc,Brand Publicity,GI-Bro,94771519,81691,50513,31178,2022-07-27
2498,Disney Studios,Media Supported Asset,Merf,99578145,81682,28662,53020,2022-10-26
2858,Google Inc.,Influencer,Clay-Dough,14524469,81676,9721,71955,2022-11-06
264,Nintendo Technologies,E-Commerce,GI-Bro,13405431,81671,21001,60670,2022-06-19
775,TikTok Inc,Media Supported Asset,Transmorphers,98932369,81666,11498,70168,2022-12-21
226,Google Inc.,E-Commerce,Transmorphers,70007635,81663,16159,65504,2022-11-14
4638,Google Inc.,Media Supported Asset,GI-Bro,84466964,81602,1670,79932,2022-01-16
3036,TikTok Inc,Influencer,Space Wars,74690516,81596,11068,70528,2022-11-07
1861,KYG Antler LLC,Brand Asset Development,Clay-Dough,87472078,81564,4771,76793,2022-10-28
1917,TikTok Inc,Media Supported Asset,Merf,59015250,81534,39876,41658,2022-09-16
3717,Google Inc.,Influencer,Space Wars,75823953,81493,38066,43427,2022-05-01
2253,TikTok Inc,Influencer,GI-Bro,49718200,81492,673,80819,2022-11-13
1631,KYG Antler LLC,Media Supported Asset,Clay-Dough,11979517,81492,9075,72417,2022-09-04
673,TikTok Inc,Brand Asset Development,GI-Bro,45611488,81481,16219,65262,2022-10-27
4625,The Martingale Agency,Brand Asset Development,Merf,37317667,81453,50511,30942,2022-09-17
3035,Google Inc.,Influencer,Merf,40136838,81450,23262,58188,2022-07-28
4684,The Martingale Agency,E-Commerce,Clay-Dough,65576092,81419,33738,47681,2022-04-05
410,Meta Platforms,Influencer,Clay-Dough,38028665,81414,44737,36677,2022-08-23
3068,Google Inc.,Brand Publicity,GI-Bro,84219024,81381,71433,9948,2022-06-25
1658,Disney Studios,E-Commerce,Transmorphers,96280298,81379,21728,59651,2022-12-09
2305,The Martingale Agency,E-Commerce,Transmorphers,42766302,81375,477,80898,2022-12-01
1219,Pinterest Inc,Influencer,Space Wars,23761265,81369,19253,62116,2022-10-30
1309,Google Inc.,Influencer,Clay-Dough,69426497,81331,31450,49881,2022-01-12
918,TikTok Inc,Brand Publicity,Space Wars,47839570,81320,18647,62673,2022-09-11
803,Meta Platforms,Brand Asset Development,Transmorphers,28389795,81265,471,80794,2022-05-04
36,Google Inc.,Media Supported Asset,Clay-Dough,10413327,81215,9873,71342,2022-04-01
2923,Meta Platforms,Brand Publicity,GI-Bro,45043071,81207,54274,26933,2022-07-25
4304,Nintendo Technologies,Influencer,Clay-Dough,12323276,81204,47424,33780,2022-06-15
70,Nintendo Technologies,Media Supported Asset,Clay-Dough,82045420,81200,27658,53542,2022-04-17
4104,TikTok Inc,Influencer,GI-Bro,36453598,81157,18885,62272,2022-03-03
4042,Pinterest Inc,Media Supported Asset,GI-Bro,52917357,81112,44244,36868,2022-03-13
2634,Nintendo Technologies,Influencer,Clay-Dough,32600976,81111,80418,693,2022-06-23
1576,Disney Studios,E-Commerce,Clay-Dough,58555138,81091,52880,28211,2022-03-26
147,Nintendo Technologies,Brand Publicity,Merf,13053633,81050,25480,55570,2022-11-03
4236,KYG Antler LLC,Influencer,Transmorphers,22649919,81028,18132,62896,2022-07-27
3858,Meta Platforms,Brand Asset Development,Transmorphers,59142669,81007,31248,49759,2022-07-05
423,Meta Platforms,Brand Asset Development,Space Wars,41382386,80989,16210,64779,2022-05-25
1424,Meta Platforms,Media Supported Asset,Merf,78093506,80971,22053,58918,2022-09-08
2837,Meta Platforms,Brand Publicity,Transmorphers,44470784,80958,13723,67235,2022-07-05
1505,Pinterest Inc,Brand Publicity,Space Wars,25147838,80929,22078,58851,2022-11-09
2196,Pinterest Inc,Influencer,GI-Bro,79065795,80925,38941,41984,2022-09-01
2869,Disney Studios,Brand Publicity,Transmorphers,11171176,80922,1112,79810,2022-08-25
4266,Pinterest Inc,Brand Asset Development,Merf,95496087,80908,21752,59156,2022-12-25
2110,Google Inc.,Brand Asset Development,Clay-Dough,19552881,80858,19711,61147,2022-12-20
2625,TikTok Inc,Media Supported Asset,Clay-Dough,26568598,80838,6539,74299,2022-10-31
4823,TikTok Inc,E-Commerce,Space Wars,60783550,80832,56824,24008,2022-04-24
1766,Nintendo Technologies,Influencer,Merf,89364824,80802,16893,63909,2022-11-20
3523,KYG Antler LLC,E-Commerce,Merf,71258892,80802,67412,13390,2022-02-01
2991,TikTok Inc,E-Commerce,Space Wars,14161029,80765,15994,64771,2022-10-02
2536,Nintendo Technologies,Brand Publicity,GI-Bro,37062507,80763,38227,42536,2022-07-14
1653,The Martingale Agency,Brand Asset Development,Space Wars,65729325,80681,2826,77855,2022-07-31
3571,Google Inc.,Brand Publicity,Merf,29854488,80670,24861,55809,2022-03-27
2200,KYG Antler LLC,Media Supported Asset,Clay-Dough,10328166,80640,18833,61807,2022-06-08
876,KYG Antler LLC,Influencer,Transmorphers,12386664,80631,21096,59535,2022-03-21
1029,KYG Antler LLC,Brand Publicity,Space Wars,15172484,80596,76988,3608,2022-02-25
2416,Disney Studios,Influencer,Transmorphers,25912172,80581,10717,69864,2022-06-01
2398,Disney Studios,Brand Publicity,Clay-Dough,28445700,80528,25063,55465,2022-10-25
3531,The Martingale Agency,Influencer,Transmorphers,52832257,80528,43318,37210,2022-08-15
4984,Pinterest Inc,Brand Publicity,Transmorphers,83577884,80521,25212,55309,2022-12-12
4773,TikTok Inc,Brand Publicity,Transmorphers,80789959,80516,8008,72508,2022-11-15
1664,TikTok Inc,Influencer,Transmorphers,28187184,80503,9439,71064,2022-10-20
2908,Pinterest Inc,Media Supported Asset,Merf,59636602,80484,39772,40712,2022-09-12
3536,TikTok Inc,Brand Publicity,Merf,70785867,80483,7677,72806,2022-11-30
1987,Meta Platforms,Brand Asset Development,Clay-Dough,22498324,80476,21761,58715,2022-09-25
2153,TikTok Inc,Brand Publicity,Merf,90139461,80473,23391,57082,2022-11-21
2986,TikTok Inc,E-Commerce,Merf,30065544,80459,3284,77175,2022-11-12
1307,Meta Platforms,Brand Asset Development,Merf,43364419,80447,20383,60064,2022-12-01
2417,KYG Antler LLC,E-Commerce,Space Wars,77084383,80444,47619,32825,2022-05-07
4093,Nintendo Technologies,Influencer,GI-Bro,55061891,80443,66814,13629,2022-01-05
3155,KYG Antler LLC,Influencer,Clay-Dough,67457753,80426,72648,7778,2022-01-07
811,Google Inc.,Brand Publicity,Transmorphers,35298228,80383,23659,56724,2022-12-08
2989,TikTok Inc,Brand Publicity,Space Wars,81601659,80362,16649,63713,2022-06-20
1356,Google Inc.,Brand Asset Development,Clay-Dough,90912244,80326,25830,54496,2022-11-11
3104,Google Inc.,Influencer,Transmorphers,63673103,80325,18559,61766,2022-10-11
1690,Google Inc.,Influencer,Space Wars,27853099,80317,18057,62260,2022-10-10
3063,Pinterest Inc,Influencer,Clay-Dough,31369900,80310,27260,53050,2022-07-03
2744,The Martingale Agency,Brand Asset Development,Merf,40932241,80253,32171,48082,2022-02-09
3224,The Martingale Agency,Brand Asset Development,GI-Bro,47440404,80214,79057,1157,2022-05-14
4131,The Martingale Agency,Influencer,Space Wars,82604010,80183,9088,71095,2022-07-06
4778,The Martingale Agency,Brand Asset Development,Clay-Dough,71445913,80178,8803,71375,2022-12-15
791,Disney Studios,Brand Publicity,Merf,78277291,80168,3500,76668,2022-10-03
1808,Nintendo Technologies,Brand Publicity,Space Wars,16494868,80148,53953,26195,2022-09-25
2052,Nintendo Technologies,Media Supported Asset,GI-Bro,69566986,80126,24634,55492,2022-04-20
3478,Meta Platforms,Influencer,Transmorphers,96250470,80125,42341,37784,2022-01-18
83,Nintendo Technologies,E-Commerce,Transmorphers,50512766,80099,51994,28105,2022-05-01
3226,The Martingale Agency,Brand Asset Development,GI-Bro,40776106,80093,46225,33868,2022-07-22
1173,Disney Studios,Brand Publicity,Merf,54115960,80080,9223,70857,2022-06-10
3521,The Martingale Agency,Brand Publicity,Clay-Dough,44723530,80023,26743,53280,2022-11-12
1503,Disney Studios,Media Supported Asset,Clay-Dough,58468720,80018,16293,63725,2022-02-17
3201,TikTok Inc,Brand Asset Development,Transmorphers,70309446,80011,40946,39065,2022-08-23
3790,The Martingale Agency,E-Commerce,Merf,29755199,80006,69927,10079,2022-06-16
256,Pinterest Inc,Influencer,GI-Bro,39423006,79997,43557,36440,2022-04-01
3253,The Martingale Agency,Influencer,Space Wars,46341610,79992,14914,65078,2022-05-24
971,Google Inc.,Brand Asset Development,Space Wars,14524807,79989,37870,42119,2022-01-12
1507,Meta Platforms,Media Supported Asset,GI-Bro,64185325,79971,10363,69608,2022-11-28
3338,The Martingale Agency,Brand Publicity,Transmorphers,13712994,79964,10835,69129,2022-10-27
39,Pinterest Inc,Media Supported Asset,Merf,66418295,79960,5891,74069,2022-05-23
1360,Disney Studios,Brand Asset Development,Space Wars,61293667,79938,72185,7753,2022-06-05
2731,Pinterest Inc,E-Commerce,Space Wars,45132793,79928,35294,44634,2022-07-16
756,KYG Antler LLC,Brand Publicity,Merf,78066018,79918,66929,12989,2022-01-02
830,KYG Antler LLC,Influencer,Merf,81275833,79918,12982,66936,2022-08-06
4760,Google Inc.,Brand Publicity,Space Wars,46212252,79897,24749,55148,2022-07-11
1852,Google Inc.,E-Commerce,GI-Bro,64034553,79876,48826,31050,2022-01-14
3986,Nintendo Technologies,Media Supported Asset,Transmorphers,81412599,79865,25793,54072,2022-11-11
2955,The Martingale Agency,Brand Asset Development,Space Wars,95307913,79857,53043,26814,2022-04-18
4697,Nintendo Technologies,Influencer,Clay-Dough,25978002,79849,56045,23804,2022-05-02
2239,Meta Platforms,E-Commerce,Merf,76715535,79829,73051,6778,2022-06-16
3141,Google Inc.,Media Supported Asset,GI-Bro,28276129,79825,33435,46390,2022-05-15
1904,KYG Antler LLC,Media Supported Asset,Space Wars,86017567,79822,21468,58354,2022-11-02
3882,Disney Studios,Influencer,GI-Bro,63468625,79798,53028,26770,2022-07-20
1492,Google Inc.,Media Supported Asset,Clay-Dough,74895829,79764,33600,46164,2022-07-28
2446,Pinterest Inc,Influencer,GI-Bro,46126876,79759,7048,72711,2022-06-21
1787,Pinterest Inc,Influencer,GI-Bro,25046438,79746,18049,61697,2022-10-09
422,KYG Antler LLC,Brand Asset Development,Space Wars,58023340,79742,21398,58344,2022-02-21
3984,Meta Platforms,Brand Publicity,Merf,65978210,79735,47892,31843,2022-05-25
2412,The Martingale Agency,Brand Publicity,Clay-Dough,70513764,79730,26606,53124,2022-08-04
2544,TikTok Inc,Influencer,Clay-Dough,17329254,79694,22879,56815,2022-10-05
2535,The Martingale Agency,Influencer,GI-Bro,91326726,79645,16299,63346,2022-03-24
4450,The Martingale Agency,Brand Asset Development,GI-Bro,39982608,79640,11452,68188,2022-06-23
4911,Disney Studios,Influencer,GI-Bro,67274880,79528,25457,54071,2022-10-21
770,Nintendo Technologies,Influencer,Transmorphers,93826447,79519,39347,40172,2022-07-23
3590,Disney Studios,E-Commerce,Clay-Dough,14902170,79509,15158,64351,2022-12-05
2862,Google Inc.,E-Commerce,Transmorphers,89499533,79456,72,79384,2022-10-15
1858,Nintendo Technologies,E-Commerce,GI-Bro,96413904,79450,53151,26299,2022-04-02
1186,Disney Studios,Brand Publicity,Transmorphers,16556472,79441,77542,1899,2022-04-26
512,Meta Platforms,Media Supported Asset,Merf,93198957,79429,40972,38457,2022-06-14
963,Nintendo Technologies,E-Commerce,Space Wars,18277110,79387,57190,22197,2022-04-11
1230,Google Inc.,E-Commerce,GI-Bro,94628070,79383,40773,38610,2022-09-21
2873,KYG Antler LLC,E-Commerce,Clay-Dough,89846092,79346,26109,53237,2022-07-17
3618,TikTok Inc,Media Supported Asset,Merf,74960383,79333,18159,61174,2022-01-05
1613,Meta Platforms,Media Supported Asset,Clay-Dough,93210117,79300,10934,68366,2022-06-02
4448,Meta Platforms,Brand Asset Development,Space Wars,79206974,79279,43454,35825,2022-06-10
3751,Nintendo Technologies,E-Commerce,Clay-Dough,33532609,79278,24283,54995,2022-12-07
3038,KYG Antler LLC,E-Commerce,Clay-Dough,92324332,79267,47152,32115,2022-03-09
2775,Meta Platforms,Brand Asset Development,Clay-Dough,34298649,79253,18123,61130,2022-07-02
4616,Disney Studios,Media Supported Asset,Merf,72574358,79197,43361,35836,2022-05-24
1897,The Martingale Agency,E-Commerce,Merf,11054464,79185,35143,44042,2022-03-18
1046,Pinterest Inc,Brand Publicity,Transmorphers,17953993,79109,17664,61445,2022-10-30
2432,Google Inc.,Influencer,Transmorphers,26671089,79106,24257,54849,2022-07-12
2345,Google Inc.,Brand Publicity,GI-Bro,75064523,79036,76650,2386,2022-02-05
697,Disney Studios,Brand Publicity,Transmorphers,24426901,79008,61834,17174,2022-02-24
4195,Nintendo Technologies,Influencer,Clay-Dough,22907232,78978,26443,52535,2022-06-17
1474,KYG Antler LLC,E-Commerce,Transmorphers,51237556,78963,29075,49888,2022-09-02
4577,TikTok Inc,E-Commerce,Transmorphers,33309479,78959,34036,44923,2022-02-09
4688,The Martingale Agency,Influencer,Clay-Dough,70955916,78939,12281,66658,2022-03-16
2419,Disney Studios,Brand Asset Development,Transmorphers,65457643,78878,47146,31732,2022-06-15
4004,The Martingale Agency,Influencer,Merf,29095627,78842,689,78153,2022-10-05
4167,TikTok Inc,Media Supported Asset,Merf,35208438,78763,50255,28508,2022-02-17
1270,Meta Platforms,Media Supported Asset,Space Wars,89614876,78750,26862,51888,2022-07-06
4006,KYG Antler LLC,Brand Asset Development,Clay-Dough,11202019,78741,44354,34387,2022-05-01
2626,Disney Studios,Brand Publicity,Clay-Dough,12282614,78686,2341,76345,2022-10-27
34,Meta Platforms,E-Commerce,Transmorphers,28168289,78626,20010,58616,2022-07-28
3850,Nintendo Technologies,E-Commerce,Clay-Dough,22213659,78619,40282,38337,2022-07-08
3629,KYG Antler LLC,Media Supported Asset,Merf,28317195,78600,29942,48658,2022-01-27
1760,Pinterest Inc,Brand Asset Development,Clay-Dough,97255840,78598,28164,50434,2022-09-07
2341,Nintendo Technologies,Media Supported Asset,Space Wars,94336450,78586,50762,27824,2022-01-28
2428,Google Inc.,Brand Asset Development,Space Wars,54031237,78571,30021,48550,2022-04-14
1592,Nintendo Technologies,Media Supported Asset,Clay-Dough,48991407,78552,5397,73155,2022-02-15
681,TikTok Inc,Brand Asset Development,Merf,58664416,78525,24989,53536,2022-01-11
4037,Nintendo Technologies,E-Commerce,Transmorphers,23846222,78514,16734,61780,2022-09-12
3429,Disney Studios,Brand Publicity,Space Wars,82037920,78508,3056,75452,2022-07-11
1610,The Martingale Agency,Media Supported Asset,Clay-Dough,61221652,78411,1267,77144,2022-10-25
3204,TikTok Inc,Brand Publicity,Transmorphers,86327856,78378,17172,61206,2022-11-17
1021,The Martingale Agency,Brand Asset Development,Space Wars,61540594,78370,67022,11348,2022-05-19
4833,The Martingale Agency,Brand Publicity,Merf,67443165,78359,30963,47396,2022-07-14
2711,Pinterest Inc,E-Commerce,GI-Bro,42947275,78356,13410,64946,2022-12-01
1417,TikTok Inc,Media Supported Asset,Clay-Dough,34316919,78352,63253,15099,2022-05-04
3232,TikTok Inc,Brand Publicity,GI-Bro,52980368,78349,42729,35620,2022-09-13
692,TikTok Inc,Influencer,Transmorphers,21642169,78324,4615,73709,2022-07-03
4772,KYG Antler LLC,Brand Publicity,Merf,96518445,78322,33880,44442,2022-03-13
4192,Pinterest Inc,Brand Asset Development,Space Wars,59716479,78288,1341,76947,2022-12-19
960,TikTok Inc,Influencer,Space Wars,18032776,78283,60795,17488,2022-03-22
2886,Disney Studios,E-Commerce,Space Wars,41608882,78222,12143,66079,2022-01-04
1841,Google Inc.,Influencer,Transmorphers,51005469,78197,9064,69133,2022-11-27
1061,Nintendo Technologies,Media Supported Asset,GI-Bro,56977474,78173,49246,28927,2022-05-09
1761,Nintendo Technologies,Influencer,GI-Bro,98247350,78170,4340,73830,2022-11-23
372,Disney Studios,E-Commerce,Space Wars,50829099,78165,60224,17941,2022-01-03
2750,TikTok Inc,Brand Asset Development,Clay-Dough,13889776,78151,4787,73364,2022-11-02
225,The Martingale Agency,Brand Asset Development,Transmorphers,93816893,78140,19445,58695,2022-02-16
3512,Nintendo Technologies,Influencer,GI-Bro,80745548,78119,23234,54885,2022-08-05
2137,Pinterest Inc,Brand Asset Development,Transmorphers,18985419,78050,54190,23860,2022-01-19
540,KYG Antler LLC,Influencer,Merf,12074269,78048,65039,13009,2022-01-02
2313,Pinterest Inc,Influencer,GI-Bro,14048940,78041,30483,47558,2022-08-05
3564,Google Inc.,Influencer,Space Wars,91662711,78003,8296,69707,2022-05-25
2238,TikTok Inc,Influencer,Space Wars,23687668,78000,35589,42411,2022-08-18
1016,The Martingale Agency,Brand Publicity,Merf,56960890,77999,24802,53197,2022-12-19
3358,Disney Studios,Brand Publicity,Transmorphers,59667375,77954,10083,67871,2022-12-16
3833,Nintendo Technologies,Brand Asset Development,Space Wars,44970528,77933,33691,44242,2022-01-26
659,Google Inc.,Brand Asset Development,Clay-Dough,61746534,77915,77818,97,2022-03-07
2354,TikTok Inc,Influencer,Clay-Dough,88627357,77905,27203,50702,2022-09-29
4397,Nintendo Technologies,Influencer,Space Wars,20923974,77904,12375,65529,2022-10-01
2519,Google Inc.,Influencer,Transmorphers,70896428,77903,49939,27964,2022-09-22
1629,Disney Studios,E-Commerce,Clay-Dough,24514337,77888,50030,27858,2022-07-06
474,Disney Studios,Brand Publicity,Clay-Dough,42678960,77839,49403,28436,2022-09-27
3318,Nintendo Technologies,Brand Asset Development,Merf,85824076,77778,20465,57313,2022-11-09
4485,Pinterest Inc,Brand Publicity,Merf,62653446,77738,17056,60682,2022-11-25
4832,TikTok Inc,E-Commerce,Merf,26461507,77712,11063,66649,2022-06-04
473,Meta Platforms,E-Commerce,Transmorphers,98453494,77711,20309,57402,2022-12-19
77,Pinterest Inc,Brand Publicity,Transmorphers,31534392,77678,51660,26018,2022-08-23
1869,The Martingale Agency,E-Commerce,GI-Bro,18584445,77656,17552,60104,2022-11-19
1383,KYG Antler LLC,E-Commerce,Space Wars,98035668,77656,6896,70760,2022-08-24
3301,Disney Studios,Influencer,Transmorphers,38724836,77642,34078,43564,2022-04-02
4923,Disney Studios,Media Supported Asset,Merf,11818869,77631,23941,53690,2022-01-03
3889,The Martingale Agency,Brand Publicity,GI-Bro,55249659,77610,24401,53209,2022-11-20
4160,Nintendo Technologies,Brand Publicity,Clay-Dough,81741591,77598,3213,74385,2022-02-25
3865,TikTok Inc,Media Supported Asset,Clay-Dough,79605498,77596,36438,41158,2022-04-19
4234,TikTok Inc,Influencer,Clay-Dough,86718695,77580,21424,56156,2022-01-12
4125,KYG Antler LLC,E-Commerce,Merf,99841630,77575,4197,73378,2022-10-19
3311,Disney Studios,E-Commerce,Space Wars,97855720,77575,19837,57738,2022-12-09
328,The Martingale Agency,Brand Publicity,GI-Bro,27447875,77508,12443,65065,2022-12-22
270,TikTok Inc,Media Supported Asset,GI-Bro,21126272,77452,16434,61018,2022-10-16
4739,KYG Antler LLC,Brand Publicity,GI-Bro,54157172,77445,66736,10709,2022-03-29
4059,Meta Platforms,Brand Publicity,Space Wars,66103585,77444,30620,46824,2022-05-09
438,Disney Studios,Brand Asset Development,Clay-Dough,78224011,77432,7157,70275,2022-11-20
3525,The Martingale Agency,Brand Asset Development,Clay-Dough,62344217,77399,1307,76092,2022-11-12
585,KYG Antler LLC,Brand Publicity,Transmorphers,71067523,77393,21344,56049,2022-12-10
2829,Google Inc.,E-Commerce,Transmorphers,59777490,77365,28300,49065,2022-05-24
1015,The Martingale Agency,Influencer,Merf,86716675,77362,4867,72495,2022-07-16
648,KYG Antler LLC,Media Supported Asset,Space Wars,35319464,77341,24677,52664,2022-09-24
3951,Nintendo Technologies,Brand Publicity,Space Wars,16396745,77329,62892,14437,2022-05-28
1460,Pinterest Inc,Influencer,GI-Bro,46387304,77241,39338,37903,2022-06-11
162,Google Inc.,Influencer,Transmorphers,17796613,77211,47906,29305,2022-08-12
3288,TikTok Inc,E-Commerce,Merf,58489604,77192,22519,54673,2022-05-19
431,Meta Platforms,Media Supported Asset,Clay-Dough,14000992,77124,20132,56992,2022-05-22
1731,Nintendo Technologies,Brand Publicity,GI-Bro,97401776,77116,51957,25159,2022-07-10
1259,TikTok Inc,Influencer,Space Wars,58680815,77115,46457,30658,2022-07-02
4567,Pinterest Inc,Brand Publicity,Space Wars,60446561,77103,7096,70007,2022-09-01
4526,KYG Antler LLC,Brand Publicity,GI-Bro,76524020,77094,13686,63408,2022-09-01
3495,Meta Platforms,Influencer,Clay-Dough,19652220,77086,18632,58454,2022-01-08
4809,Meta Platforms,Brand Publicity,Transmorphers,23060600,77029,11551,65478,2022-08-08
1345,KYG Antler LLC,Brand Asset Development,GI-Bro,74711781,76981,29155,47826,2022-06-07
1759,Pinterest Inc,Media Supported Asset,GI-Bro,83963534,76969,17861,59108,2022-12-02
1850,Meta Platforms,Brand Asset Development,Merf,32438023,76923,70200,6723,2022-03-04
640,Pinterest Inc,E-Commerce,Clay-Dough,98333002,76918,17029,59889,2022-11-16
3199,Meta Platforms,E-Commerce,Merf,45667917,76899,24764,52135,2022-02-14
4756,KYG Antler LLC,Brand Publicity,Merf,43817086,76892,11233,65659,2022-09-30
4818,Meta Platforms,Media Supported Asset,Merf,41380277,76857,18851,58006,2022-06-11
1163,Pinterest Inc,E-Commerce,Merf,48404468,76789,23704,53085,2022-05-24
4501,Google Inc.,Media Supported Asset,Merf,67889104,76764,18659,58105,2022-11-17
1748,Disney Studios,E-Commerce,Space Wars,57366553,76705,7481,69224,2022-05-10
3286,Pinterest Inc,Brand Asset Development,Merf,66403949,76704,40444,36260,2022-09-24
3922,The Martingale Agency,Brand Publicity,Clay-Dough,34177671,76691,75286,1405,2022-02-24
1979,Nintendo Technologies,Brand Asset Development,Space Wars,34398369,76668,35649,41019,2022-05-09
2409,The Martingale Agency,Influencer,Merf,37605543,76662,980,75682,2022-11-22
2904,Pinterest Inc,Media Supported Asset,Clay-Dough,26439814,76652,73270,3382,2022-05-04
2257,Nintendo Technologies,Influencer,Transmorphers,96423906,76641,4592,72049,2022-05-30
3769,Disney Studios,Media Supported Asset,Transmorphers,41507577,76635,30474,46161,2022-07-14
1303,Google Inc.,Media Supported Asset,GI-Bro,77290827,76582,52437,24145,2022-01-02
3417,The Martingale Agency,Media Supported Asset,Transmorphers,41649437,76521,8097,68424,2022-09-17
4369,Meta Platforms,Brand Publicity,GI-Bro,27168526,76520,38384,38136,2022-08-03
2399,KYG Antler LLC,Brand Asset Development,Merf,85565936,76514,9328,67186,2022-12-25
4126,Nintendo Technologies,Influencer,Merf,14882306,76506,33625,42881,2022-03-10
4658,KYG Antler LLC,Media Supported Asset,GI-Bro,90632550,76492,54333,22159,2022-04-16
693,Meta Platforms,Influencer,Space Wars,19112856,76475,57292,19183,2022-03-02
736,KYG Antler LLC,Brand Publicity,Clay-Dough,75157432,76466,9524,66942,2022-08-10
4815,Nintendo Technologies,Brand Asset Development,Space Wars,25115747,76445,23646,52799,2022-12-14
462,Pinterest Inc,Brand Publicity,Space Wars,24208645,76437,35084,41353,2022-09-22
2421,Nintendo Technologies,Brand Asset Development,Merf,33224782,76433,11400,65033,2022-12-29
19,Google Inc.,Brand Publicity,Clay-Dough,73805205,76424,10419,66005,2022-12-17
1292,Nintendo Technologies,Brand Publicity,GI-Bro,61298914,76421,74809,1612,2022-05-18
4896,Google Inc.,Brand Asset Development,Space Wars,72342107,76415,48754,27661,2022-08-10
4333,Disney Studios,Media Supported Asset,Transmorphers,75034955,76412,22721,53691,2022-10-26
2051,TikTok Inc,Influencer,Transmorphers,59662170,76407,1272,75135,2022-02-10
3177,TikTok Inc,E-Commerce,Transmorphers,68876202,76393,62234,14159,2022-05-28
4885,TikTok Inc,Media Supported Asset,Transmorphers,30458334,76374,7541,68833,2022-12-14
2484,Disney Studios,E-Commerce,Space Wars,71708568,76347,16009,60338,2022-12-22
2865,Nintendo Technologies,Media Supported Asset,Transmorphers,18597779,76331,1804,74527,2022-07-18
3061,Disney Studios,Media Supported Asset,GI-Bro,92147555,76307,34630,41677,2022-09-18
258,Meta Platforms,E-Commerce,Clay-Dough,25609645,76288,986,75302,2022-11-26
1693,The Martingale Agency,Brand Asset Development,Merf,26341728,76283,18851,57432,2022-04-09
4770,KYG Antler LLC,E-Commerce,GI-Bro,67408462,76256,4624,71632,2022-08-04
785,TikTok Inc,Media Supported Asset,Transmorphers,17503313,76190,19664,56526,2022-05-09
4839,TikTok Inc,Brand Publicity,Transmorphers,90338109,76188,12649,63539,2022-11-17
4743,Nintendo Technologies,E-Commerce,Clay-Dough,39122219,76172,17482,58690,2022-12-17
3673,TikTok Inc,Brand Asset Development,Space Wars,20700809,76124,38686,37438,2022-06-26
3496,The Martingale Agency,E-Commerce,Space Wars,25495718,76100,13851,62249,2022-02-09
4177,Pinterest Inc,Influencer,Merf,53466185,76090,14591,61499,2022-01-14
3102,Nintendo Technologies,Brand Asset Development,Clay-Dough,81467812,76066,62046,14020,2022-05-15
504,Pinterest Inc,E-Commerce,Space Wars,45481084,76040,52676,23364,2022-01-22
3004,Google Inc.,Influencer,Space Wars,56143846,76036,59427,16609,2022-01-26
804,Nintendo Technologies,Brand Asset Development,GI-Bro,40652064,76035,30492,45543,2022-08-01
597,TikTok Inc,Brand Asset Development,Space Wars,19313406,76018,14140,61878,2022-10-01
1406,TikTok Inc,Media Supported Asset,Space Wars,47561140,75989,4590,71399,2022-01-20
1596,Disney Studios,Influencer,Space Wars,22164254,75969,21706,54263,2022-10-23
2848,Pinterest Inc,Influencer,GI-Bro,95867528,75948,21654,54294,2022-08-26
1489,KYG Antler LLC,Influencer,Transmorphers,95560075,75946,23934,52012,2022-07-25
1924,Pinterest Inc,Brand Publicity,Transmorphers,92297399,75935,5939,69996,2022-07-10
3179,Pinterest Inc,Influencer,GI-Bro,32156210,75923,52135,23788,2022-03-12
3688,Meta Platforms,E-Commerce,Space Wars,25575787,75922,5829,70093,2022-05-09
4527,KYG Antler LLC,Influencer,Clay-Dough,80150602,75896,39649,36247,2022-06-10
57,The Martingale Agency,Brand Publicity,Space Wars,16240712,75874,22810,53064,2022-02-10
4607,Pinterest Inc,Influencer,Merf,85190316,75859,39852,36007,2022-01-20
2973,KYG Antler LLC,Influencer,Transmorphers,47081666,75859,24328,51531,2022-11-19
792,KYG Antler LLC,E-Commerce,Merf,60070436,75822,14064,61758,2022-09-11
2765,TikTok Inc,Brand Asset Development,Merf,54513344,75817,12066,63751,2022-09-06
1442,The Martingale Agency,Media Supported Asset,Clay-Dough,48553610,75803,46599,29204,2022-08-22
295,Disney Studios,Brand Asset Development,Space Wars,35503046,75798,45947,29851,2022-05-05
3151,KYG Antler LLC,Brand Publicity,Clay-Dough,34685792,75717,8716,67001,2022-10-19
2682,Meta Platforms,Influencer,Merf,81483678,75712,69992,5720,2022-02-10
2697,Disney Studios,Media Supported Asset,Space Wars,73613320,75691,27857,47834,2022-08-25
3494,Google Inc.,Media Supported Asset,Transmorphers,31921186,75638,25331,50307,2022-08-31
1942,Nintendo Technologies,Brand Publicity,GI-Bro,41149604,75606,46814,28792,2022-07-30
3302,Pinterest Inc,Influencer,GI-Bro,30673167,75600,2056,73544,2022-05-29
3797,Google Inc.,Brand Publicity,Clay-Dough,56648201,75575,41013,34562,2022-03-02
530,Disney Studios,Brand Asset Development,Space Wars,29134956,75558,61148,14410,2022-06-20
4329,Meta Platforms,E-Commerce,Merf,27443902,75547,7907,67640,2022-07-02
1544,TikTok Inc,E-Commerce,Clay-Dough,23076806,75546,412,75134,2022-03-23
32,Nintendo Technologies,Brand Publicity,GI-Bro,44716219,75537,60971,14566,2022-02-21
3122,KYG Antler LLC,Influencer,Clay-Dough,55895579,75513,12199,63314,2022-11-08
4690,KYG Antler LLC,Influencer,Transmorphers,65928214,75506,39395,36111,2022-07-05
938,Pinterest Inc,Media Supported Asset,Merf,44462481,75496,39187,36309,2022-05-13
351,The Martingale Agency,Brand Asset Development,Clay-Dough,58182170,75470,58083,17387,2022-04-21
4110,Meta Platforms,Brand Publicity,Transmorphers,58984921,75449,10165,65284,2022-11-10
2649,Pinterest Inc,Brand Publicity,Space Wars,62877545,75394,24464,50930,2022-11-10
4940,The Martingale Agency,Brand Asset Development,GI-Bro,56378758,75382,11675,63707,2022-10-27
1439,KYG Antler LLC,Brand Asset Development,Merf,92418823,75379,46057,29322,2022-03-14
506,Meta Platforms,Media Supported Asset,Transmorphers,69394428,75373,34748,40625,2022-08-02
4348,The Martingale Agency,Brand Asset Development,GI-Bro,12032679,75355,50715,24640,2022-05-08
4543,TikTok Inc,E-Commerce,Clay-Dough,31846069,75322,17995,57327,2022-05-21
4097,TikTok Inc,Brand Publicity,Clay-Dough,91015208,75305,30142,45163,2022-04-09
3563,Google Inc.,E-Commerce,Clay-Dough,92857433,75239,29131,46108,2022-04-02
4546,Google Inc.,E-Commerce,Merf,46999821,75221,7594,67627,2022-08-05
4605,KYG Antler LLC,Media Supported Asset,Space Wars,60178122,75195,10826,64369,2022-10-29
4263,The Martingale Agency,Media Supported Asset,Merf,38506007,75176,36,75140,2022-11-12
4145,Pinterest Inc,Media Supported Asset,Space Wars,47799260,75146,62803,12343,2022-03-27
1238,Meta Platforms,Brand Publicity,Space Wars,37796878,75134,24698,50436,2022-10-18
2669,Disney Studios,Brand Publicity,Clay-Dough,52163726,75125,17718,57407,2022-03-12
4840,KYG Antler LLC,Brand Publicity,Transmorphers,35675090,74962,34397,40565,2022-09-15
2362,Google Inc.,Influencer,Transmorphers,71951537,74928,48222,26706,2022-09-28
2725,Meta Platforms,Brand Asset Development,Merf,31887011,74884,27605,47279,2022-07-30
4197,Pinterest Inc,Brand Publicity,GI-Bro,67573548,74878,797,74081,2022-11-22
3592,TikTok Inc,Influencer,Merf,69344437,74833,19798,55035,2022-07-15
1912,KYG Antler LLC,Brand Publicity,Transmorphers,60656906,74805,7466,67339,2022-01-24
1862,Pinterest Inc,Brand Asset Development,Transmorphers,23469910,74802,5137,69665,2022-09-27
3277,Nintendo Technologies,E-Commerce,Clay-Dough,71482064,74798,22849,51949,2022-04-11
3647,Nintendo Technologies,Media Supported Asset,GI-Bro,94072114,74763,40476,34287,2022-08-02
1671,Meta Platforms,Media Supported Asset,Merf,83963332,74757,2359,72398,2022-12-20
1290,TikTok Inc,Brand Publicity,Clay-Dough,74067919,74739,21635,53104,2022-10-14
386,Pinterest Inc,Brand Asset Development,Space Wars,14645024,74691,43746,30945,2022-08-07
891,Nintendo Technologies,Media Supported Asset,Space Wars,57869683,74660,40909,33751,2022-05-25
4738,KYG Antler LLC,Influencer,Clay-Dough,31473667,74623,29416,45207,2022-03-31
3295,KYG Antler LLC,E-Commerce,Space Wars,94471044,74587,70769,3818,2022-03-10
1260,Pinterest Inc,Media Supported Asset,Space Wars,92700673,74563,16040,58523,2022-06-25
4892,TikTok Inc,Brand Asset Development,Merf,90683318,74561,68613,5948,2022-02-26
4627,TikTok Inc,Brand Asset Development,Transmorphers,69660191,74537,44781,29756,2022-05-13
107,Google Inc.,Brand Publicity,GI-Bro,33288150,74527,19021,55506,2022-03-31
1859,TikTok Inc,Brand Asset Development,Clay-Dough,91251391,74506,39186,35320,2022-05-16
818,Disney Studios,Brand Publicity,Merf,76954808,74502,59336,15166,2022-03-12
2054,TikTok Inc,Brand Publicity,GI-Bro,11130214,74439,60353,14086,2022-02-13
1630,Meta Platforms,Brand Publicity,GI-Bro,12230918,74435,10912,63523,2022-09-05
1591,KYG Antler LLC,Influencer,GI-Bro,37190305,74411,46973,27438,2022-09-30
411,Google Inc.,E-Commerce,Transmorphers,32756355,74394,7109,67285,2022-08-21
4225,Pinterest Inc,Brand Publicity,GI-Bro,43820367,74391,35658,38733,2022-09-14
1727,The Martingale Agency,Influencer,GI-Bro,80047155,74370,7301,67069,2022-08-16
590,Disney Studios,Influencer,Clay-Dough,86514411,74344,10130,64214,2022-10-15
1847,The Martingale Agency,Media Supported Asset,Transmorphers,82796467,74331,8842,65489,2022-10-01
3585,Meta Platforms,E-Commerce,GI-Bro,17110375,74294,69924,4370,2022-06-10
3626,Disney Studios,Media Supported Asset,Space Wars,45714536,74269,11109,63160,2022-03-09
3653,Pinterest Inc,Brand Asset Development,Merf,40528111,74266,58705,15561,2022-01-06
1925,The Martingale Agency,E-Commerce,GI-Bro,15822083,74246,9288,64958,2022-12-06
4719,The Martingale Agency,E-Commerce,Space Wars,87698105,74238,22160,52078,2022-07-22
220,TikTok Inc,Media Supported Asset,Space Wars,80360828,74236,24786,49450,2022-03-21
970,Pinterest Inc,Brand Asset Development,Transmorphers,86595149,74230,2796,71434,2022-02-01
4537,KYG Antler LLC,E-Commerce,Merf,58663960,74225,64678,9547,2022-05-04
2105,The Martingale Agency,E-Commerce,Clay-Dough,91653542,74201,73043,1158,2022-04-01
3732,Pinterest Inc,Media Supported Asset,GI-Bro,48644299,74187,27665,46522,2022-08-18
641,Meta Platforms,Brand Publicity,Clay-Dough,40792469,74180,34564,39616,2022-09-04
939,Meta Platforms,E-Commerce,Space Wars,28918824,74169,53179,20990,2022-06-29
3871,Disney Studios,E-Commerce,Space Wars,29306015,74166,32272,41894,2022-09-06
1738,Google Inc.,Media Supported Asset,Clay-Dough,92073220,74165,7381,66784,2022-10-04
301,Google Inc.,Media Supported Asset,Space Wars,63739910,74142,17358,56784,2022-08-11
4255,Nintendo Technologies,Brand Asset Development,Merf,46445842,74140,20126,54014,2022-07-07
910,Pinterest Inc,Media Supported Asset,Merf,72939931,74140,22167,51973,2022-11-12
4536,Pinterest Inc,Brand Asset Development,Transmorphers,81114420,74139,14912,59227,2022-05-11
4981,KYG Antler LLC,Brand Asset Development,Transmorphers,43008893,74128,1347,72781,2022-12-24
2293,The Martingale Agency,E-Commerce,Space Wars,18248755,74105,62591,11514,2022-03-08
2834,Pinterest Inc,Brand Publicity,Transmorphers,66093863,74075,31792,42283,2022-01-23
669,Google Inc.,Brand Asset Development,Space Wars,50156943,74072,20126,53946,2022-10-16
3400,The Martingale Agency,E-Commerce,Transmorphers,33495640,74066,28739,45327,2022-06-18
1469,Disney Studios,Influencer,Space Wars,38222371,74004,11168,62836,2022-12-11
73,Google Inc.,E-Commerce,Merf,52484453,74004,24653,49351,2022-09-30
3913,KYG Antler LLC,Brand Asset Development,Space Wars,95624878,74000,20727,53273,2022-10-07
2811,Nintendo Technologies,Influencer,Space Wars,19563171,73959,45789,28170,2022-05-31
4222,Disney Studios,Influencer,Transmorphers,27253935,73933,33020,40913,2022-08-01
2572,Meta Platforms,Brand Asset Development,Clay-Dough,57371400,73825,8917,64908,2022-12-23
1275,Nintendo Technologies,Media Supported Asset,Space Wars,38940682,73804,54832,18972,2022-03-14
503,Pinterest Inc,Media Supported Asset,GI-Bro,13962860,73787,7969,65818,2022-01-16
2084,Nintendo Technologies,Influencer,Transmorphers,30562549,73741,22925,50816,2022-03-18
931,Pinterest Inc,E-Commerce,GI-Bro,16309485,73737,39713,34024,2022-07-14
668,Meta Platforms,Brand Asset Development,GI-Bro,94541152,73734,69361,4373,2022-03-13
4639,KYG Antler LLC,Influencer,Transmorphers,22297375,73659,22800,50859,2022-12-25
1767,KYG Antler LLC,Influencer,Merf,30419432,73646,4423,69223,2022-10-16
4261,TikTok Inc,Brand Publicity,GI-Bro,44699070,73600,32280,41320,2022-03-29
4886,TikTok Inc,Media Supported Asset,Merf,63130416,73597,23214,50383,2022-10-08
2242,TikTok Inc,E-Commerce,Space Wars,98895266,73572,9776,63796,2022-09-01
200,Meta Platforms,E-Commerce,Merf,57561778,73571,31128,42443,2022-06-17
3284,Disney Studios,Brand Publicity,GI-Bro,10609714,73549,9402,64147,2022-11-24
1393,Pinterest Inc,Influencer,GI-Bro,25548705,73533,14739,58794,2022-08-27
88,TikTok Inc,Media Supported Asset,Clay-Dough,70303136,73528,24027,49501,2022-08-22
3681,Disney Studios,Brand Asset Development,Clay-Dough,56322812,73483,13195,60288,2022-05-04
3628,Meta Platforms,Media Supported Asset,Clay-Dough,10389756,73432,46701,26731,2022-09-12
913,TikTok Inc,E-Commerce,Clay-Dough,34468188,73431,1900,71531,2022-12-11
3056,Pinterest Inc,Influencer,Clay-Dough,79869724,73428,67149,6279,2022-06-18
3078,Google Inc.,Brand Publicity,Merf,14472936,73427,16948,56479,2022-08-06
984,Nintendo Technologies,Brand Asset Development,Merf,57937972,73394,41424,31970,2022-05-01
3562,KYG Antler LLC,Brand Publicity,GI-Bro,21564176,73391,13849,59542,2022-07-04
798,Pinterest Inc,Influencer,Merf,40916631,73375,16363,57012,2022-02-13
3103,Disney Studios,Influencer,Space Wars,76891524,73362,2990,70372,2022-12-01
4722,Google Inc.,Influencer,Clay-Dough,49637917,73359,10251,63108,2022-11-05
4774,Disney Studios,Brand Asset Development,Transmorphers,37411706,73346,65015,8331,2022-06-24
1707,KYG Antler LLC,Brand Asset Development,GI-Bro,24895149,73323,212,73111,2022-05-26
4641,Google Inc.,Media Supported Asset,Space Wars,82480431,73319,18665,54654,2022-10-27
415,TikTok Inc,Brand Asset Development,Merf,78147424,73295,32849,40446,2022-03-11
3101,KYG Antler LLC,Brand Asset Development,Space Wars,99177613,73284,10391,62893,2022-11-14
4673,TikTok Inc,Brand Asset Development,Transmorphers,15498055,73252,73170,82,2022-01-04
3546,Nintendo Technologies,Media Supported Asset,Transmorphers,21241984,73226,35094,38132,2022-02-27
3126,Google Inc.,Brand Publicity,GI-Bro,52782800,73198,1140,72058,2022-03-19
4409,Pinterest Inc,Brand Asset Development,Space Wars,40339298,73193,59932,13261,2022-04-07
4842,Nintendo Technologies,Media Supported Asset,Transmorphers,66398423,73172,37011,36161,2022-01-18
4796,Nintendo Technologies,E-Commerce,Transmorphers,13751729,73155,7740,65415,2022-06-04
1461,Disney Studios,E-Commerce,Transmorphers,41796940,73154,11254,61900,2022-07-07
3105,Meta Platforms,Media Supported Asset,Space Wars,44218173,73153,60283,12870,2022-05-28
1600,The Martingale Agency,Influencer,Space Wars,16648116,73095,4901,68194,2022-07-26
845,KYG Antler LLC,Brand Asset Development,Clay-Dough,93383373,73086,17002,56084,2022-12-13
1813,The Martingale Agency,Media Supported Asset,Transmorphers,94448818,73065,4023,69042,2022-04-29
2478,Meta Platforms,E-Commerce,Space Wars,99211275,72991,4373,68618,2022-11-23
1883,Meta Platforms,Media Supported Asset,Transmorphers,92845940,72956,3505,69451,2022-08-31
3220,Meta Platforms,Influencer,Space Wars,86442598,72943,15066,57877,2022-07-27
4903,TikTok Inc,Media Supported Asset,Merf,58035857,72926,43854,29072,2022-01-11
2294,Google Inc.,E-Commerce,Clay-Dough,22267101,72910,16979,55931,2022-11-09
4761,Pinterest Inc,Brand Asset Development,Clay-Dough,95571021,72891,67794,5097,2022-03-28
4853,Meta Platforms,Influencer,Transmorphers,73789354,72881,22480,50401,2022-10-29
4733,TikTok Inc,Media Supported Asset,Space Wars,16758937,72871,7836,65035,2022-07-12
663,TikTok Inc,Media Supported Asset,Transmorphers,83376742,72869,21976,50893,2022-09-25
4201,Nintendo Technologies,Brand Asset Development,Merf,45591101,72849,2934,69915,2022-01-24
1910,TikTok Inc,Brand Publicity,Clay-Dough,39369324,72824,2421,70403,2022-10-14
135,Meta Platforms,Media Supported Asset,Merf,67268979,72804,30351,42453,2022-06-14
1280,Pinterest Inc,Brand Asset Development,Transmorphers,99252954,72795,41054,31741,2022-08-02
1074,Pinterest Inc,Brand Asset Development,GI-Bro,47756465,72777,12048,60729,2022-12-19
4635,TikTok Inc,Brand Publicity,Space Wars,75312434,72776,29636,43140,2022-08-22
739,Meta Platforms,Brand Asset Development,Clay-Dough,50769551,72769,62501,10268,2022-06-16
4980,KYG Antler LLC,Influencer,Merf,93444030,72745,31404,41341,2022-06-04
965,Meta Platforms,Brand Publicity,Merf,37083700,72742,16783,55959,2022-10-23
4709,TikTok Inc,Influencer,GI-Bro,30208037,72687,63273,9414,2022-03-08
1048,The Martingale Agency,E-Commerce,Space Wars,53272521,72650,7019,65631,2022-11-11
382,Disney Studios,Brand Publicity,Space Wars,42583158,72627,9518,63109,2022-12-25
4801,Nintendo Technologies,Brand Asset Development,Space Wars,50401518,72593,50163,22430,2022-03-27
2559,Disney Studios,Brand Publicity,Clay-Dough,48298092,72578,1051,71527,2022-11-29
3364,Pinterest Inc,Influencer,Merf,72055741,72566,2759,69807,2022-12-22
2268,The Martingale Agency,Media Supported Asset,Transmorphers,44294864,72544,31852,40692,2022-02-16
63,KYG Antler LLC,Influencer,Merf,93602772,72542,43846,28696,2022-08-09
2162,Nintendo Technologies,E-Commerce,Merf,95666777,72495,12561,59934,2022-06-25
716,Pinterest Inc,Brand Publicity,Space Wars,36971775,72490,21054,51436,2022-11-25
2228,Nintendo Technologies,Influencer,Merf,68788702,72472,64549,7923,2022-06-27
4298,KYG Antler LLC,Brand Asset Development,Merf,89148924,72436,5559,66877,2022-08-25
1865,Nintendo Technologies,Influencer,Merf,98538581,72420,71560,860,2022-04-10
1467,Meta Platforms,E-Commerce,GI-Bro,82596844,72401,13113,59288,2022-10-14
526,Meta Platforms,Influencer,Space Wars,79518526,72391,36348,36043,2022-07-18
3661,TikTok Inc,Media Supported Asset,Clay-Dough,21549641,72336,29872,42464,2022-06-26
1047,The Martingale Agency,Brand Asset Development,Transmorphers,90352919,72310,16100,56210,2022-12-07
1562,Nintendo Technologies,Influencer,Space Wars,99747443,72303,22822,49481,2022-06-11
1837,TikTok Inc,E-Commerce,Merf,83585386,72264,38318,33946,2022-09-02
3839,Disney Studios,Brand Asset Development,Space Wars,50590253,72251,33809,38442,2022-05-14
4784,The Martingale Agency,Influencer,Space Wars,37177088,72166,6910,65256,2022-12-15
2557,Google Inc.,Brand Asset Development,Clay-Dough,67521822,72166,49177,22989,2022-05-05
4123,TikTok Inc,Brand Publicity,Transmorphers,18429577,72164,1385,70779,2022-07-15
3242,Disney Studios,Brand Asset Development,Clay-Dough,91138688,72136,19966,52170,2022-04-21
1641,Pinterest Inc,Brand Publicity,Clay-Dough,37491934,72122,2018,70104,2022-09-10
4178,KYG Antler LLC,Brand Asset Development,GI-Bro,51419844,72116,32759,39357,2022-05-08
2599,Pinterest Inc,Brand Asset Development,GI-Bro,67194657,72090,1178,70912,2022-08-27
4524,KYG Antler LLC,Media Supported Asset,Transmorphers,26756400,72044,41202,30842,2022-05-19
167,Meta Platforms,Influencer,Merf,16002198,71983,28268,43715,2022-04-22
2255,Disney Studios,Brand Publicity,Space Wars,92458607,71978,51926,20052,2022-06-06
4076,TikTok Inc,Brand Asset Development,Space Wars,72258609,71978,71853,125,2022-04-19
1995,Google Inc.,E-Commerce,Clay-Dough,80563299,71976,68806,3170,2022-02-21
708,Meta Platforms,E-Commerce,Merf,21799921,71938,62383,9555,2022-04-01
4754,KYG Antler LLC,E-Commerce,Transmorphers,73954356,71915,36742,35173,2022-03-22
76,KYG Antler LLC,Brand Asset Development,Transmorphers,39954478,71889,62724,9165,2022-01-20
1445,Google Inc.,E-Commerce,GI-Bro,17321206,71884,65010,6874,2022-02-18
3837,Pinterest Inc,Media Supported Asset,Transmorphers,39831181,71841,4615,67226,2022-08-17
2447,Meta Platforms,Brand Publicity,Clay-Dough,72793376,71810,48460,23350,2022-01-01
53,Meta Platforms,Brand Asset Development,GI-Bro,39914454,71803,878,70925,2022-08-02
3847,KYG Antler LLC,Brand Asset Development,GI-Bro,65290119,71785,4425,67360,2022-02-22
4226,KYG Antler LLC,E-Commerce,Clay-Dough,71831514,71782,14907,56875,2022-11-10
38,Disney Studios,Brand Publicity,Clay-Dough,16077744,71781,47063,24718,2022-02-26
1455,KYG Antler LLC,Brand Asset Development,GI-Bro,27905226,71762,18659,53103,2022-10-08
3406,Google Inc.,Influencer,Clay-Dough,77351805,71750,17986,53764,2022-06-08
2058,KYG Antler LLC,Media Supported Asset,Clay-Dough,16245021,71746,9880,61866,2022-12-25
2787,Google Inc.,Influencer,Space Wars,26344920,71718,19420,52298,2022-05-20
699,KYG Antler LLC,Media Supported Asset,Transmorphers,16839568,71713,36092,35621,2022-04-11
1543,Pinterest Inc,Brand Publicity,Merf,19888367,71707,12680,59027,2022-04-05
738,Nintendo Technologies,E-Commerce,Merf,33838041,71686,18366,53320,2022-07-19
1566,The Martingale Agency,Brand Publicity,Space Wars,61246945,71654,55695,15959,2022-02-08
2001,TikTok Inc,Brand Asset Development,Merf,78086611,71566,4226,67340,2022-08-21
213,Disney Studios,E-Commerce,Space Wars,47189992,71545,4926,66619,2022-12-09
1602,Disney Studios,E-Commerce,Transmorphers,20024860,71543,12041,59502,2022-08-15
814,Disney Studios,Media Supported Asset,Transmorphers,77810531,71513,8427,63086,2022-08-14
2164,Nintendo Technologies,Influencer,GI-Bro,92466826,71505,45550,25955,2022-09-27
3024,The Martingale Agency,Brand Asset Development,Merf,25329575,71487,70689,798,2022-05-22
4101,Google Inc.,E-Commerce,Transmorphers,33861567,71485,69627,1858,2022-05-12
370,Meta Platforms,Influencer,Clay-Dough,53816964,71483,18063,53420,2022-12-01
4193,Nintendo Technologies,Media Supported Asset,Clay-Dough,30292959,71474,18263,53211,2022-12-05
4235,KYG Antler LLC,E-Commerce,Clay-Dough,90625078,71448,9811,61637,2022-02-04
4161,Disney Studios,Influencer,Space Wars,60461907,71440,28576,42864,2022-09-15
3171,Pinterest Inc,Influencer,Merf,87625782,71423,31768,39655,2022-08-17
4276,TikTok Inc,Brand Asset Development,Space Wars,24372141,71407,199,71208,2022-08-30
1210,KYG Antler LLC,Brand Asset Development,Merf,48380389,71402,11189,60213,2022-11-12
2366,Pinterest Inc,Media Supported Asset,GI-Bro,10652782,71375,11487,59888,2022-07-13
1519,KYG Antler LLC,Media Supported Asset,Merf,37477417,71374,3001,68373,2022-07-11
1214,TikTok Inc,Influencer,Transmorphers,72431483,71361,14539,56822,2022-10-26
4386,KYG Antler LLC,Brand Publicity,GI-Bro,28244329,71322,18267,53055,2022-12-20
4483,Pinterest Inc,Media Supported Asset,Clay-Dough,15812520,71310,42607,28703,2022-02-06
4116,Meta Platforms,Brand Publicity,Space Wars,40306730,71307,32210,39097,2022-07-13
765,Nintendo Technologies,Brand Publicity,Space Wars,61231517,71304,3035,68269,2022-02-15
1011,Google Inc.,Influencer,Transmorphers,37404737,71290,31015,40275,2022-08-04
1831,Pinterest Inc,Brand Asset Development,Transmorphers,95531952,71266,17594,53672,2022-03-19
1449,Disney Studios,Influencer,GI-Bro,36452321,71236,20927,50309,2022-03-23
3322,The Martingale Agency,Brand Asset Development,Merf,29893472,71208,28208,43000,2022-04-06
923,Nintendo Technologies,Media Supported Asset,Transmorphers,97046625,71141,33270,37871,2022-05-02
1946,KYG Antler LLC,Influencer,Merf,70605703,71112,41901,29211,2022-07-26
1408,Nintendo Technologies,Media Supported Asset,Merf,55094933,71090,63748,7342,2022-06-17
4592,Nintendo Technologies,Brand Publicity,Clay-Dough,70539286,71088,39456,31632,2022-01-24
2802,TikTok Inc,Influencer,Space Wars,79388021,71082,35406,35676,2022-03-24
129,Pinterest Inc,Brand Asset Development,Clay-Dough,13851000,71040,4819,66221,2022-08-26
3074,Google Inc.,E-Commerce,Clay-Dough,64973763,70958,68515,2443,2022-06-19
852,The Martingale Agency,Brand Asset Development,Transmorphers,39776885,70955,20385,50570,2022-12-23
1459,Nintendo Technologies,Brand Publicity,Space Wars,95121270,70910,9143,61767,2022-03-22
1992,Disney Studios,E-Commerce,Transmorphers,12748670,70905,8557,62348,2022-10-01
1660,Nintendo Technologies,Brand Publicity,Merf,79172441,70899,54078,16821,2022-02-14
4558,The Martingale Agency,Brand Publicity,Space Wars,36276886,70875,6592,64283,2022-03-09
4970,KYG Antler LLC,E-Commerce,Merf,75400562,70856,21147,49709,2022-05-04
1603,Meta Platforms,Influencer,Merf,59589242,70839,48286,22553,2022-06-25
396,Google Inc.,Brand Asset Development,GI-Bro,56026276,70832,7795,63037,2022-11-04
3260,TikTok Inc,Media Supported Asset,Space Wars,46190067,70803,784,70019,2022-09-25
700,Meta Platforms,Brand Asset Development,Transmorphers,11021753,70732,60904,9828,2022-02-14
1185,Meta Platforms,Influencer,Merf,56953497,70729,11141,59588,2022-07-04
48,KYG Antler LLC,Influencer,Transmorphers,30956580,70725,5935,64790,2022-08-28
3851,The Martingale Agency,Media Supported Asset,Transmorphers,58532428,70718,5741,64977,2022-10-01
2867,Disney Studios,Media Supported Asset,Clay-Dough,99555841,70695,4301,66394,2022-10-18
2774,Nintendo Technologies,Influencer,Space Wars,16521489,70691,7407,63284,2022-10-26
2644,The Martingale Agency,Brand Publicity,Merf,92664190,70663,52742,17921,2022-01-12
45,The Martingale Agency,Influencer,Clay-Dough,33646376,70652,2802,67850,2022-11-18
1839,Pinterest Inc,Influencer,Merf,22315324,70609,17546,53063,2022-01-04
2585,Meta Platforms,Influencer,Transmorphers,53269307,70582,5461,65121,2022-07-02
3806,Google Inc.,Brand Asset Development,Merf,72075016,70558,24002,46556,2022-02-27
1149,Nintendo Technologies,Media Supported Asset,GI-Bro,59279512,70509,25028,45481,2022-04-13
1863,Meta Platforms,Influencer,Transmorphers,36013258,70506,21023,49483,2022-07-22
2179,Google Inc.,Brand Asset Development,GI-Bro,27281811,70491,7585,62906,2022-11-13
4018,Disney Studios,Brand Publicity,Space Wars,33575978,70479,35813,34666,2022-07-23
1378,KYG Antler LLC,Brand Asset Development,Merf,79219882,70475,44017,26458,2022-01-08
4343,Nintendo Technologies,Media Supported Asset,GI-Bro,47298578,70441,42800,27641,2022-09-01
3168,The Martingale Agency,Influencer,Clay-Dough,24119106,70438,12146,58292,2022-10-24
3009,TikTok Inc,Media Supported Asset,Merf,14817101,70402,9675,60727,2022-10-19
2424,Google Inc.,Influencer,Space Wars,42331797,70390,30163,40227,2022-09-10
1318,Pinterest Inc,E-Commerce,Space Wars,17074845,70388,6616,63772,2022-05-18
2639,Disney Studios,Brand Asset Development,Merf,67580490,70384,16860,53524,2022-08-23
3803,Pinterest Inc,Media Supported Asset,Merf,89039976,70363,5100,65263,2022-08-21
4158,KYG Antler LLC,Brand Publicity,Space Wars,16557366,70361,25808,44553,2022-02-06
3836,Pinterest Inc,Media Supported Asset,GI-Bro,34648010,70341,18474,51867,2022-12-29
2671,Meta Platforms,Media Supported Asset,Clay-Dough,88568787,70332,34756,35576,2022-05-27
1635,Disney Studios,Media Supported Asset,Space Wars,74699275,70315,11540,58775,2022-11-13
3857,Disney Studios,Brand Asset Development,Merf,15782704,70305,47495,22810,2022-05-13
203,The Martingale Agency,E-Commerce,Transmorphers,61361342,70283,19625,50658,2022-05-12
188,Pinterest Inc,Influencer,Transmorphers,16491112,70271,37793,32478,2022-01-09
3712,KYG Antler LLC,Influencer,Space Wars,12975749,70256,33583,36673,2022-06-06
4767,KYG Antler LLC,Media Supported Asset,Transmorphers,48078718,70256,58227,12029,2022-06-14
1606,Meta Platforms,Brand Asset Development,Clay-Dough,47458666,70245,63458,6787,2022-04-29
666,KYG Antler LLC,Brand Asset Development,GI-Bro,61230761,70224,8387,61837,2022-12-29
4447,Pinterest Inc,Brand Asset Development,Transmorphers,47429422,70190,48121,22069,2022-03-20
2208,Meta Platforms,Brand Publicity,Merf,45269280,70186,38186,32000,2022-03-05
1250,Disney Studios,Brand Asset Development,Clay-Dough,93239056,70185,63971,6214,2022-06-22
3892,Nintendo Technologies,Influencer,Transmorphers,56991182,70184,68284,1900,2022-01-23
1959,Meta Platforms,Brand Publicity,Clay-Dough,50377018,70177,14692,55485,2022-04-24
91,TikTok Inc,Brand Publicity,Transmorphers,71421354,70171,20568,49603,2022-08-04
3903,TikTok Inc,E-Commerce,Merf,72255476,70171,25289,44882,2022-09-27
3832,Pinterest Inc,E-Commerce,Transmorphers,62658780,70162,35966,34196,2022-05-07
644,Meta Platforms,E-Commerce,Merf,82339283,70150,8871,61279,2022-11-18
3433,Meta Platforms,E-Commerce,GI-Bro,52883776,70133,46867,23266,2022-01-08
3757,Nintendo Technologies,Brand Asset Development,Merf,48333815,70119,36354,33765,2022-02-01
4121,KYG Antler LLC,Influencer,Clay-Dough,75918545,70110,5669,64441,2022-09-19
591,Meta Platforms,Brand Asset Development,Transmorphers,50173583,70098,26673,43425,2022-04-10
152,TikTok Inc,E-Commerce,Space Wars,73595513,70052,18349,51703,2022-02-08
4283,Disney Studios,Brand Asset Development,Transmorphers,78228661,70047,22839,47208,2022-09-22
3634,Disney Studios,Media Supported Asset,Merf,19621330,70021,13796,56225,2022-06-05
3706,Nintendo Technologies,E-Commerce,GI-Bro,21346306,69961,65803,4158,2022-06-13
2907,The Martingale Agency,Brand Publicity,GI-Bro,18231982,69959,33680,36279,2022-09-08
1686,Disney Studios,Media Supported Asset,Space Wars,81821927,69944,25331,44613,2022-01-17
599,Google Inc.,Brand Asset Development,GI-Bro,75055279,69927,62996,6931,2022-05-22
4932,Nintendo Technologies,Media Supported Asset,GI-Bro,92194129,69917,23639,46278,2022-04-20
4918,Pinterest Inc,Influencer,Transmorphers,52519727,69906,34993,34913,2022-06-24
4454,Nintendo Technologies,E-Commerce,Clay-Dough,66988825,69872,69611,261,2022-03-24
1941,Google Inc.,Influencer,Transmorphers,54196396,69836,52738,17098,2022-06-05
1873,Nintendo Technologies,Influencer,Space Wars,12233878,69754,14352,55402,2022-09-03
2847,The Martingale Agency,Brand Asset Development,GI-Bro,96083546,69688,4538,65150,2022-11-21
2156,TikTok Inc,E-Commerce,Transmorphers,70656331,69671,55541,14130,2022-02-19
3083,Google Inc.,Brand Publicity,Clay-Dough,92449719,69656,13039,56617,2022-11-22
525,Google Inc.,Brand Asset Development,Merf,92536633,69621,44367,25254,2022-05-26
2041,Nintendo Technologies,E-Commerce,GI-Bro,40751510,69581,41317,28264,2022-04-28
4140,Meta Platforms,E-Commerce,GI-Bro,85487333,69564,568,68996,2022-07-06
233,TikTok Inc,Brand Asset Development,Clay-Dough,21754946,69554,44192,25362,2022-03-28
1319,Meta Platforms,E-Commerce,Clay-Dough,61987075,69541,37149,32392,2022-07-05
2610,Meta Platforms,Influencer,Clay-Dough,29722968,69540,4270,65270,2022-04-19
1511,Disney Studios,Brand Publicity,Merf,17419943,69536,42607,26929,2022-01-01
760,KYG Antler LLC,Media Supported Asset,Clay-Dough,95735342,69521,46562,22959,2022-04-25
2352,KYG Antler LLC,Media Supported Asset,Transmorphers,44772196,69443,46558,22885,2022-03-18
3291,Nintendo Technologies,E-Commerce,Clay-Dough,21168898,69434,40754,28680,2022-09-18
4570,KYG Antler LLC,Influencer,Transmorphers,19066686,69432,413,69019,2022-11-01
3772,Meta Platforms,Brand Asset Development,Merf,32844908,69431,46985,22446,2022-04-26
3698,Disney Studios,Media Supported Asset,Merf,21565393,69421,3341,66080,2022-09-04
4250,KYG Antler LLC,Influencer,GI-Bro,66974982,69417,18520,50897,2022-11-09
905,Google Inc.,Influencer,Clay-Dough,50223709,69399,33278,36121,2022-04-11
4525,Google Inc.,Media Supported Asset,Transmorphers,41593648,69392,27905,41487,2022-09-12
1138,The Martingale Agency,Media Supported Asset,Merf,13614603,69373,3489,65884,2022-11-19
2901,Pinterest Inc,E-Commerce,Clay-Dough,14885387,69366,61183,8183,2022-06-26
72,Meta Platforms,Brand Publicity,Transmorphers,85218521,69364,49279,20085,2022-06-11
567,KYG Antler LLC,Media Supported Asset,Merf,78708418,69354,7555,61799,2022-01-07
3655,The Martingale Agency,E-Commerce,GI-Bro,98985074,69353,3314,66039,2022-10-02
878,TikTok Inc,Influencer,Merf,88599209,69351,48057,21294,2022-06-12
1088,Pinterest Inc,Influencer,GI-Bro,47910307,69306,8155,61151,2022-11-26
3075,Nintendo Technologies,Influencer,Merf,37999725,69294,43295,25999,2022-09-19
2406,The Martingale Agency,Influencer,Transmorphers,50794187,69263,32132,37131,2022-07-26
4977,Disney Studios,E-Commerce,GI-Bro,47382528,69263,909,68354,2022-09-11
2088,Nintendo Technologies,E-Commerce,GI-Bro,19685671,69223,30603,38620,2022-02-24
2081,TikTok Inc,Brand Publicity,Transmorphers,75876607,69217,8412,60805,2022-08-09
3761,Google Inc.,Influencer,GI-Bro,94120834,69203,19899,49304,2022-07-31
2346,Disney Studios,Media Supported Asset,Transmorphers,79974321,69201,4624,64577,2022-12-21
2555,The Martingale Agency,Brand Publicity,Transmorphers,79447943,69186,67953,1233,2022-03-01
2218,Pinterest Inc,Brand Asset Development,Space Wars,16364577,69179,25658,43521,2022-08-24
252,Nintendo Technologies,Media Supported Asset,Space Wars,39833956,69164,49469,19695,2022-03-19
1581,Nintendo Technologies,Brand Asset Development,GI-Bro,84309340,69127,37205,31922,2022-08-06
3479,KYG Antler LLC,Media Supported Asset,Space Wars,38157845,69126,18174,50952,2022-03-26
394,Google Inc.,Brand Publicity,GI-Bro,35132818,69115,4872,64243,2022-10-08
1093,Meta Platforms,Media Supported Asset,Clay-Dough,19259519,69113,424,68689,2022-11-28
1485,Nintendo Technologies,Brand Asset Development,Transmorphers,20509930,69076,55154,13922,2022-01-06
4417,Nintendo Technologies,Brand Asset Development,Transmorphers,28158657,69076,57865,11211,2022-02-18
4080,Nintendo Technologies,Brand Publicity,Merf,56601838,69071,42423,26648,2022-06-07
1527,TikTok Inc,Brand Asset Development,GI-Bro,66378386,69056,33200,35856,2022-05-08
2627,KYG Antler LLC,E-Commerce,GI-Bro,40975401,69051,35443,33608,2022-08-03
2121,The Martingale Agency,E-Commerce,Space Wars,62148277,69013,45485,23528,2022-03-17
58,Meta Platforms,Influencer,Transmorphers,78384979,69002,26480,42522,2022-09-23
2530,Disney Studios,Brand Publicity,GI-Bro,58779954,68983,30686,38297,2022-08-17
2670,The Martingale Agency,Influencer,Space Wars,54963995,68979,60363,8616,2022-05-06
1004,Disney Studios,Influencer,Transmorphers,14538095,68975,45148,23827,2022-05-05
3615,Google Inc.,Media Supported Asset,Transmorphers,86895722,68971,8443,60528,2022-12-04
1357,Nintendo Technologies,Influencer,Merf,60661859,68938,42621,26317,2022-07-21
2593,KYG Antler LLC,Media Supported Asset,Transmorphers,35769927,68926,18337,50589,2022-01-11
1416,Pinterest Inc,Influencer,GI-Bro,13605688,68921,3775,65146,2022-04-29
4425,Nintendo Technologies,Media Supported Asset,Merf,61636267,68917,7538,61379,2022-07-05
1151,Nintendo Technologies,Brand Publicity,Clay-Dough,89398068,68911,36175,32736,2022-04-16
3940,The Martingale Agency,Brand Asset Development,Merf,16623122,68885,5363,63522,2022-06-01
1771,Disney Studios,Brand Asset Development,Transmorphers,51314135,68872,40664,28208,2022-09-17
1179,Disney Studios,Brand Asset Development,Space Wars,71644605,68854,351,68503,2022-11-24
2193,Nintendo Technologies,Brand Asset Development,GI-Bro,54240185,68842,21211,47631,2022-06-01
40,The Martingale Agency,Media Supported Asset,Transmorphers,15899424,68836,53618,15218,2022-01-10
4184,Nintendo Technologies,Brand Publicity,Clay-Dough,18499427,68803,14971,53832,2022-08-02
2931,Nintendo Technologies,Brand Publicity,Transmorphers,71486776,68802,27552,41250,2022-09-08
4630,Pinterest Inc,E-Commerce,Space Wars,92576251,68776,32284,36492,2022-04-28
4865,TikTok Inc,Media Supported Asset,Space Wars,54743425,68765,7775,60990,2022-11-29
2813,Pinterest Inc,Brand Asset Development,Merf,72727692,68734,31947,36787,2022-09-30
3265,Meta Platforms,Brand Publicity,GI-Bro,65677270,68713,27300,41413,2022-04-01
3933,Disney Studios,E-Commerce,Transmorphers,76760677,68698,44230,24468,2022-05-24
393,Google Inc.,E-Commerce,Space Wars,62587760,68679,61361,7318,2022-04-15
788,Pinterest Inc,Brand Publicity,GI-Bro,65633267,68671,21601,47070,2022-08-22
4954,Meta Platforms,Brand Publicity,GI-Bro,56359163,68637,11993,56644,2022-11-28
943,The Martingale Agency,Brand Asset Development,Clay-Dough,52571696,68618,1449,67169,2022-04-24
4518,Pinterest Inc,E-Commerce,GI-Bro,31150798,68589,11597,56992,2022-01-06
4695,TikTok Inc,Brand Asset Development,Clay-Dough,94907083,68584,13598,54986,2022-10-31
652,TikTok Inc,E-Commerce,Space Wars,67215818,68571,59425,9146,2022-04-07
704,Google Inc.,Brand Publicity,Clay-Dough,82000489,68559,9318,59241,2022-06-24
1515,The Martingale Agency,Brand Publicity,Space Wars,75616659,68531,25541,42990,2022-04-04
1123,Meta Platforms,Media Supported Asset,GI-Bro,97468631,68507,11685,56822,2022-04-18
1756,The Martingale Agency,Brand Asset Development,Clay-Dough,42106131,68490,7669,60821,2022-08-03
634,KYG Antler LLC,Brand Asset Development,Merf,90197970,68489,5407,63082,2022-11-17
2047,TikTok Inc,Media Supported Asset,Transmorphers,94217808,68447,64338,4109,2022-03-23
4172,Meta Platforms,Influencer,Transmorphers,64320274,68378,5469,62909,2022-11-13
4365,KYG Antler LLC,Brand Publicity,Merf,19901687,68365,12447,55918,2022-07-24
912,Google Inc.,Brand Publicity,Space Wars,37443407,68346,16787,51559,2022-10-18
4864,Pinterest Inc,Influencer,Clay-Dough,34406929,68319,18735,49584,2022-01-16
2524,TikTok Inc,Brand Asset Development,Space Wars,85434465,68284,10265,58019,2022-12-12
1040,Pinterest Inc,Brand Asset Development,Merf,75124389,68269,13926,54343,2022-04-12
694,Disney Studios,Brand Asset Development,Space Wars,35705213,68263,27133,41130,2022-07-06
112,Pinterest Inc,Brand Publicity,Space Wars,52521251,68253,65290,2963,2022-06-18
1973,Google Inc.,Brand Asset Development,Transmorphers,19054498,68240,64617,3623,2022-01-10
4026,Pinterest Inc,Brand Publicity,Space Wars,51085563,68231,36359,31872,2022-08-15
800,TikTok Inc,Brand Asset Development,Clay-Dough,14722067,68211,24447,43764,2022-02-13
290,Pinterest Inc,Media Supported Asset,Merf,97572457,68199,36697,31502,2022-08-29
3994,Nintendo Technologies,Brand Publicity,Space Wars,59177366,68181,3728,64453,2022-10-22
674,Pinterest Inc,E-Commerce,GI-Bro,58161331,68176,21582,46594,2022-07-04
4661,Meta Platforms,Brand Publicity,GI-Bro,10244322,68148,482,67666,2022-02-13
1,Pinterest Inc,Influencer,Clay-Dough,15930994,68141,50400,17741,2022-06-21
4224,The Martingale Agency,Brand Asset Development,Transmorphers,63129722,68093,10819,57274,2022-04-17
4878,KYG Antler LLC,Brand Publicity,Clay-Dough,41727242,68078,38104,29974,2022-05-19
4303,Nintendo Technologies,E-Commerce,Transmorphers,79295180,68073,60174,7899,2022-05-26
4219,Pinterest Inc,Media Supported Asset,GI-Bro,42662911,68064,13322,54742,2022-06-04
1067,Disney Studios,E-Commerce,Clay-Dough,58714903,68056,21021,47035,2022-04-16
4299,Nintendo Technologies,Brand Asset Development,Space Wars,47893034,68030,6568,61462,2022-12-13
4734,TikTok Inc,Brand Asset Development,Transmorphers,45725264,68014,19906,48108,2022-09-07
3240,KYG Antler LLC,E-Commerce,Clay-Dough,73390321,68006,27813,40193,2022-02-08
3011,Google Inc.,Media Supported Asset,GI-Bro,22911858,67992,32825,35167,2022-07-23
911,Disney Studios,Brand Asset Development,Space Wars,43307860,67984,18196,49788,2022-06-20
2320,Pinterest Inc,Media Supported Asset,Transmorphers,23762168,67983,32041,35942,2022-08-09
4936,Nintendo Technologies,Brand Publicity,Space Wars,50900413,67929,309,67620,2022-03-22
1588,Google Inc.,Brand Asset Development,Clay-Dough,25727538,67926,9272,58654,2022-11-29
3687,KYG Antler LLC,Media Supported Asset,Space Wars,24963024,67921,25092,42829,2022-01-24
1323,Google Inc.,Media Supported Asset,Clay-Dough,16200921,67920,12388,55532,2022-12-23
4619,Disney Studios,Brand Publicity,Merf,89714506,67920,38294,29626,2022-08-02
4086,Google Inc.,Media Supported Asset,GI-Bro,84650387,67911,14716,53195,2022-02-20
620,Google Inc.,Brand Asset Development,Space Wars,41373285,67865,1208,66657,2022-08-28
2080,Nintendo Technologies,Brand Asset Development,Transmorphers,59100801,67855,30090,37765,2022-08-08
2451,Meta Platforms,Brand Asset Development,GI-Bro,62846808,67855,42419,25436,2022-03-03
1348,Pinterest Inc,E-Commerce,GI-Bro,27293821,67787,7746,60041,2022-10-18
1780,Disney Studios,Brand Asset Development,Merf,68399471,67784,2347,65437,2022-09-29
403,The Martingale Agency,Brand Publicity,GI-Bro,10481171,67770,8852,58918,2022-09-06
2144,Pinterest Inc,Influencer,Space Wars,21520382,67755,26507,41248,2022-04-05
1513,Pinterest Inc,Brand Asset Development,Merf,71500739,67744,32679,35065,2022-06-17
2198,Disney Studios,Brand Asset Development,Clay-Dough,16999708,67706,15597,52109,2022-10-30
1571,Nintendo Technologies,Influencer,GI-Bro,65154146,67705,396,67309,2022-12-19
1539,Pinterest Inc,Brand Asset Development,Space Wars,48222157,67700,987,66713,2022-04-28
60,TikTok Inc,Brand Publicity,Transmorphers,42958474,67695,13330,54365,2022-11-02
1464,KYG Antler LLC,Brand Asset Development,Merf,75245166,67686,9745,57941,2022-04-25
368,Nintendo Technologies,Brand Asset Development,Clay-Dough,37487805,67650,15822,51828,2022-12-27
2766,Meta Platforms,Media Supported Asset,Transmorphers,40643031,67646,10336,57310,2022-12-03
2027,Google Inc.,Brand Publicity,Space Wars,11675886,67615,13191,54424,2022-09-01
61,TikTok Inc,Influencer,Transmorphers,56395557,67612,21769,45843,2022-07-29
1848,Disney Studios,Media Supported Asset,Clay-Dough,74432930,67551,8295,59256,2022-12-28
130,KYG Antler LLC,Influencer,Transmorphers,75414877,67538,36972,30566,2022-08-24
3093,KYG Antler LLC,Influencer,Transmorphers,19675365,67466,14164,53302,2022-01-31
1133,KYG Antler LLC,Influencer,Clay-Dough,31509321,67454,5897,61557,2022-12-16
3911,Nintendo Technologies,Brand Asset Development,Clay-Dough,21317665,67419,22542,44877,2022-09-02
2422,Google Inc.,Brand Publicity,Merf,34088466,67394,42180,25214,2022-01-01
3622,Nintendo Technologies,E-Commerce,Space Wars,64872427,67353,11769,55584,2022-09-05
3432,The Martingale Agency,E-Commerce,Clay-Dough,35918559,67343,29405,37938,2022-06-19
3584,Meta Platforms,E-Commerce,GI-Bro,94369098,67326,64306,3020,2022-01-19
2645,Pinterest Inc,E-Commerce,Space Wars,58844133,67314,4493,62821,2022-12-18
643,Pinterest Inc,Influencer,GI-Bro,22946742,67307,16075,51232,2022-05-30
789,Nintendo Technologies,Brand Publicity,Clay-Dough,55684527,67302,6619,60683,2022-10-26
2506,Pinterest Inc,Influencer,Transmorphers,29791120,67295,61047,6248,2022-06-12
1184,KYG Antler LLC,E-Commerce,Merf,12754851,67293,58657,8636,2022-06-08
2331,Google Inc.,Brand Asset Development,Merf,67505757,67242,23612,43630,2022-09-12
4632,Meta Platforms,E-Commerce,Space Wars,87487920,67234,9383,57851,2022-10-01
1019,The Martingale Agency,Brand Asset Development,Clay-Dough,74302679,67227,6793,60434,2022-12-21
3743,Nintendo Technologies,Media Supported Asset,Transmorphers,58911756,67187,7703,59484,2022-12-16
3287,Google Inc.,E-Commerce,Transmorphers,60141378,67176,10051,57125,2022-11-28
3475,Disney Studios,Influencer,Merf,24802792,67168,7339,59829,2022-04-22
4723,Meta Platforms,Media Supported Asset,Clay-Dough,84020506,67139,57216,9923,2022-04-15
1329,Pinterest Inc,Media Supported Asset,Space Wars,32424520,67132,35522,31610,2022-09-16
2099,Pinterest Inc,Influencer,Clay-Dough,77338651,67098,16068,51030,2022-01-23
1062,Nintendo Technologies,Brand Asset Development,GI-Bro,17029050,67071,4924,62147,2022-11-22
280,TikTok Inc,Influencer,GI-Bro,39173065,67019,62540,4479,2022-03-20
2043,Pinterest Inc,Influencer,Space Wars,63926497,67013,39016,27997,2022-07-20
1886,Disney Studios,Media Supported Asset,Space Wars,32340474,67013,12617,54396,2022-07-12
966,Nintendo Technologies,Influencer,Transmorphers,76109022,66987,5711,61276,2022-10-19
134,TikTok Inc,Brand Publicity,Space Wars,47266842,66983,44733,22250,2022-04-01
1647,Google Inc.,E-Commerce,Transmorphers,83899459,66969,3327,63642,2022-06-08
463,TikTok Inc,Brand Publicity,Transmorphers,98048242,66944,16594,50350,2022-11-09
360,Meta Platforms,Media Supported Asset,Transmorphers,75262228,66928,11172,55756,2022-12-21
2688,Google Inc.,E-Commerce,GI-Bro,54921524,66922,1989,64933,2022-09-29
2062,TikTok Inc,Media Supported Asset,Merf,99230336,66836,11332,55504,2022-10-28
3440,Google Inc.,Influencer,Space Wars,60718527,66760,3446,63314,2022-11-12
2039,Nintendo Technologies,Media Supported Asset,Space Wars,71919473,66743,10338,56405,2022-09-06
1900,TikTok Inc,Brand Asset Development,Clay-Dough,56613306,66723,8483,58240,2022-12-20
861,Pinterest Inc,Influencer,Clay-Dough,29335712,66704,36732,29972,2022-08-07
479,Nintendo Technologies,Influencer,Space Wars,35540537,66703,24648,42055,2022-03-05
2736,The Martingale Agency,E-Commerce,Merf,40310636,66681,16621,50060,2022-06-16
2212,Nintendo Technologies,Brand Publicity,Merf,46555708,66637,5010,61627,2022-12-05
4552,TikTok Inc,Influencer,Merf,11858002,66632,11217,55415,2022-11-09
2087,KYG Antler LLC,Influencer,Space Wars,71727090,66630,46510,20120,2022-03-21
1209,Meta Platforms,Brand Asset Development,Clay-Dough,55553794,66604,41561,25043,2022-02-16
871,TikTok Inc,Influencer,Transmorphers,27553884,66574,28105,38469,2022-09-04
3143,Disney Studios,Media Supported Asset,GI-Bro,69810651,66569,62396,4173,2022-01-08
784,Meta Platforms,Media Supported Asset,Clay-Dough,96565587,66566,23385,43181,2022-09-27
2205,Pinterest Inc,Brand Publicity,Clay-Dough,22914584,66548,38893,27655,2022-08-25
4438,Nintendo Technologies,E-Commerce,Space Wars,81172429,66494,14645,51849,2022-12-24
4368,Google Inc.,Media Supported Asset,GI-Bro,84103849,66472,15868,50604,2022-11-06
3087,Nintendo Technologies,E-Commerce,Clay-Dough,33035033,66435,46017,20418,2022-02-14
1188,The Martingale Agency,Brand Asset Development,Transmorphers,49739614,66424,6907,59517,2022-12-13
1713,TikTok Inc,Brand Asset Development,GI-Bro,34086675,66376,11763,54613,2022-11-22
1150,KYG Antler LLC,Brand Asset Development,GI-Bro,45628208,66363,60020,6343,2022-01-15
2657,Google Inc.,Brand Asset Development,Space Wars,97056352,66346,1014,65332,2022-12-01
762,TikTok Inc,Media Supported Asset,Transmorphers,61627994,66339,3012,63327,2022-08-11
1157,Pinterest Inc,Brand Publicity,Clay-Dough,26172598,66339,8601,57738,2022-08-07
2546,Meta Platforms,Brand Asset Development,Transmorphers,86814033,66322,57120,9202,2022-05-31
364,Pinterest Inc,Brand Asset Development,GI-Bro,68591908,66304,4745,61559,2022-11-09
3855,Meta Platforms,Brand Asset Development,Merf,77158361,66224,30029,36195,2022-07-24
4429,Pinterest Inc,Brand Publicity,Space Wars,83125769,66197,57860,8337,2022-05-10
2254,Google Inc.,Media Supported Asset,Clay-Dough,80497188,66181,62885,3296,2022-06-23
2117,Pinterest Inc,Influencer,Merf,64333404,66170,59683,6487,2022-06-13
661,Google Inc.,Influencer,Merf,43748580,66169,11345,54824,2022-01-24
1052,Pinterest Inc,Influencer,GI-Bro,15952172,66136,27184,38952,2022-04-23
3974,Disney Studios,Brand Publicity,GI-Bro,88666370,66104,22519,43585,2022-01-07
4621,TikTok Inc,Brand Publicity,GI-Bro,43796030,66078,17428,48650,2022-01-17
30,Nintendo Technologies,Brand Asset Development,Merf,95029735,66063,43295,22768,2022-05-22
2906,Pinterest Inc,Brand Asset Development,GI-Bro,11696326,66042,5246,60796,2022-08-17
4854,Meta Platforms,Influencer,Clay-Dough,96472902,66021,9861,56160,2022-11-14
2471,KYG Antler LLC,Brand Asset Development,GI-Bro,68773279,66021,14410,51611,2022-12-12
854,Meta Platforms,Media Supported Asset,Transmorphers,36468926,65981,34450,31531,2022-02-25
2747,Google Inc.,Media Supported Asset,Clay-Dough,57003731,65965,60977,4988,2022-01-06
1628,The Martingale Agency,Media Supported Asset,Transmorphers,22658944,65949,35531,30418,2022-03-09
4112,KYG Antler LLC,Media Supported Asset,Space Wars,75657955,65942,30774,35168,2022-08-20
1352,Pinterest Inc,Influencer,Merf,14280447,65924,13000,52924,2022-12-24
4996,TikTok Inc,Influencer,Transmorphers,10166297,65916,40807,25109,2022-04-22
2119,Pinterest Inc,Media Supported Asset,Transmorphers,99161468,65880,22793,43087,2022-07-19
4043,Pinterest Inc,Brand Publicity,GI-Bro,10481694,65876,21158,44718,2022-01-30
4718,Meta Platforms,Media Supported Asset,Clay-Dough,75880808,65869,13738,52131,2022-08-30
797,Google Inc.,Influencer,Merf,77075712,65848,50958,14890,2022-06-21
3207,Meta Platforms,Media Supported Asset,Transmorphers,65334180,65839,17764,48075,2022-04-12
3043,Meta Platforms,Brand Publicity,Merf,36775328,65818,55903,9915,2022-05-15
3930,KYG Antler LLC,Brand Asset Development,Space Wars,60332713,65783,13053,52730,2022-08-31
4152,Pinterest Inc,Influencer,GI-Bro,39785654,65776,10179,55597,2022-05-16
3943,Pinterest Inc,Brand Publicity,Clay-Dough,58221333,65745,35466,30279,2022-09-12
2178,KYG Antler LLC,Brand Asset Development,Clay-Dough,89000504,65732,26033,39699,2022-09-19
1225,Meta Platforms,Influencer,Space Wars,96222178,65729,13769,51960,2022-07-20
3414,KYG Antler LLC,Brand Publicity,GI-Bro,23546883,65694,873,64821,2022-09-28
1627,Pinterest Inc,Brand Asset Development,Clay-Dough,87368605,65675,15735,49940,2022-03-12
2177,KYG Antler LLC,Media Supported Asset,Merf,46646280,65673,3646,62027,2022-07-08
3450,Pinterest Inc,Brand Asset Development,Clay-Dough,59747546,65667,26421,39246,2022-07-16
1050,Meta Platforms,Influencer,Clay-Dough,37932853,65641,5655,59986,2022-04-17
981,Meta Platforms,E-Commerce,Transmorphers,42726504,65622,11253,54369,2022-10-31
657,KYG Antler LLC,E-Commerce,Merf,71951910,65621,27864,37757,2022-02-03
495,Meta Platforms,Media Supported Asset,Space Wars,77048312,65620,55098,10522,2022-06-01
3443,Pinterest Inc,E-Commerce,GI-Bro,10346055,65597,54228,11369,2022-06-16
1926,Google Inc.,E-Commerce,Clay-Dough,28678951,65570,5255,60315,2022-02-21
4290,TikTok Inc,Influencer,GI-Bro,31573244,65519,36600,28919,2022-07-22
82,The Martingale Agency,Influencer,Merf,41950229,65516,9025,56491,2022-11-13
4698,The Martingale Agency,Media Supported Asset,Clay-Dough,71013892,65506,1701,63805,2022-08-23
4061,The Martingale Agency,Brand Asset Development,Transmorphers,35094144,65466,50911,14555,2022-05-18
4547,The Martingale Agency,Media Supported Asset,Transmorphers,56064681,65457,13422,52035,2022-10-12
4620,Disney Studios,E-Commerce,Space Wars,57137929,65423,61314,4109,2022-05-29
2056,TikTok Inc,Influencer,Space Wars,21905089,65420,37608,27812,2022-07-27
4746,Google Inc.,Brand Publicity,Space Wars,53665810,65382,5824,59558,2022-03-27
1650,Meta Platforms,Brand Asset Development,Space Wars,15023921,65341,27491,37850,2022-06-29
3229,Nintendo Technologies,Brand Publicity,Space Wars,78008831,65306,11165,54141,2022-03-16
3959,Disney Studios,Brand Asset Development,GI-Bro,64624231,65301,9388,55913,2022-07-24
2806,Disney Studios,Influencer,Space Wars,14503963,65265,45865,19400,2022-06-20
4181,KYG Antler LLC,Influencer,Space Wars,60740737,65251,25072,40179,2022-04-27
1120,KYG Antler LLC,Media Supported Asset,Clay-Dough,46506513,65152,23708,41444,2022-06-12
15,The Martingale Agency,Media Supported Asset,Transmorphers,18869696,65115,23764,41351,2022-07-03
2014,KYG Antler LLC,E-Commerce,Merf,22704998,65102,12061,53041,2022-10-25
4677,Meta Platforms,Brand Publicity,Transmorphers,34437931,65084,20727,44357,2022-08-19
1913,TikTok Inc,Influencer,Merf,41584939,65079,1603,63476,2022-03-28
2642,Pinterest Inc,Media Supported Asset,Transmorphers,43124028,65066,45241,19825,2022-05-16
4894,Disney Studios,Brand Asset Development,Merf,43651359,65063,11910,53153,2022-12-17
1962,TikTok Inc,Influencer,Transmorphers,69224720,65060,11622,53438,2022-12-15
1220,Disney Studios,Brand Asset Development,Clay-Dough,33442552,65000,26981,38019,2022-08-28
571,Meta Platforms,E-Commerce,Clay-Dough,10383675,64992,28816,36176,2022-09-03
4420,Google Inc.,Media Supported Asset,Space Wars,72469087,64986,12833,52153,2022-05-28
4503,Disney Studios,Brand Publicity,Merf,83475358,64982,6836,58146,2022-08-11
1278,TikTok Inc,Brand Asset Development,Clay-Dough,64121653,64913,21634,43279,2022-01-08
4260,KYG Antler LLC,Brand Asset Development,Merf,99203871,64867,38589,26278,2022-01-20
1580,Meta Platforms,Brand Publicity,GI-Bro,74145347,64858,13578,51280,2022-07-21
3520,Nintendo Technologies,Media Supported Asset,Space Wars,33736012,64849,56999,7850,2022-05-29
875,Meta Platforms,Influencer,Transmorphers,43473294,64849,19227,45622,2022-07-09
2217,KYG Antler LLC,Brand Asset Development,Transmorphers,70442496,64823,18924,45899,2022-03-16
2505,TikTok Inc,Brand Publicity,Clay-Dough,34852233,64759,33955,30804,2022-09-29
2522,KYG Antler LLC,Influencer,Transmorphers,84447869,64739,21024,43715,2022-03-22
2145,Nintendo Technologies,Media Supported Asset,Clay-Dough,80650440,64698,41955,22743,2022-04-19
605,Disney Studios,Brand Asset Development,Merf,56924714,64675,52830,11845,2022-03-27
2635,Meta Platforms,Media Supported Asset,Clay-Dough,78297871,64645,10877,53768,2022-08-30
4634,Nintendo Technologies,Media Supported Asset,Space Wars,41626792,64617,13748,50869,2022-08-27
3113,TikTok Inc,Brand Asset Development,Clay-Dough,25925999,64583,49946,14637,2022-03-09
3125,Meta Platforms,Brand Publicity,Merf,92721299,64565,22760,41805,2022-04-04
250,Disney Studios,Influencer,Clay-Dough,28143290,64478,17335,47143,2022-08-05
4602,Disney Studios,Media Supported Asset,Space Wars,77838735,64362,3498,60864,2022-10-27
4701,Nintendo Technologies,Brand Publicity,Clay-Dough,99154829,64361,5802,58559,2022-10-25
695,TikTok Inc,Influencer,Merf,47317027,64357,45732,18625,2022-01-01
2817,Disney Studios,Brand Publicity,GI-Bro,31983835,64350,55034,9316,2022-06-06
4362,KYG Antler LLC,Media Supported Asset,Transmorphers,87761270,64274,25539,38735,2022-09-04
3768,Google Inc.,Brand Asset Development,Clay-Dough,93484008,64268,52874,11394,2022-05-06
3616,Nintendo Technologies,Brand Asset Development,GI-Bro,12320724,64264,24385,39879,2022-06-15
4835,Google Inc.,Media Supported Asset,Clay-Dough,31462670,64262,41908,22354,2022-06-14
563,Meta Platforms,Brand Asset Development,Space Wars,55546937,64260,6888,57372,2022-12-12
580,TikTok Inc,Media Supported Asset,Merf,63887739,64253,45700,18553,2022-01-29
2115,Meta Platforms,E-Commerce,Space Wars,34139585,64250,50439,13811,2022-01-15
4072,Disney Studios,Brand Publicity,Transmorphers,85059566,64246,6625,57621,2022-11-24
722,Google Inc.,E-Commerce,Merf,29458522,64230,2102,62128,2022-10-10
1039,Nintendo Technologies,Influencer,Space Wars,18054789,64206,19946,44260,2022-07-12
2676,Google Inc.,Media Supported Asset,Clay-Dough,69434115,64186,54256,9930,2022-06-23
2433,The Martingale Agency,E-Commerce,GI-Bro,13278770,64179,55587,8592,2022-04-09
3146,Disney Studios,Brand Publicity,Space Wars,35128232,64170,42569,21601,2022-02-27
1373,TikTok Inc,Media Supported Asset,Space Wars,29908743,64168,9684,54484,2022-01-02
3763,The Martingale Agency,Media Supported Asset,Merf,59881676,64161,62789,1372,2022-04-18
2175,Google Inc.,Media Supported Asset,Transmorphers,35983449,64130,6814,57316,2022-12-20
1963,TikTok Inc,E-Commerce,Clay-Dough,15012369,64115,2208,61907,2022-07-09
779,Meta Platforms,E-Commerce,Space Wars,44039063,64089,8493,55596,2022-12-13
2998,TikTok Inc,Influencer,GI-Bro,86972517,64054,2183,61871,2022-07-29
3086,The Martingale Agency,Influencer,Space Wars,47846944,64048,20307,43741,2022-06-13
4300,Pinterest Inc,Brand Publicity,Clay-Dough,89001327,64026,9177,54849,2022-12-16
1885,Pinterest Inc,Brand Publicity,Space Wars,52745111,64018,8827,55191,2022-11-15
3353,TikTok Inc,Brand Publicity,Space Wars,55434825,64017,5384,58633,2022-05-31
1999,Pinterest Inc,Media Supported Asset,Space Wars,71910472,63995,17380,46615,2022-04-01
3040,Disney Studios,Media Supported Asset,Clay-Dough,67817995,63988,11633,52355,2022-04-26
329,Pinterest Inc,Brand Asset Development,Clay-Dough,83019706,63954,1605,62349,2022-06-23
4238,Disney Studios,Brand Publicity,Space Wars,63765512,63936,33233,30703,2022-09-07
2020,Pinterest Inc,Media Supported Asset,GI-Bro,67879924,63901,40372,23529,2022-02-07
4705,TikTok Inc,Influencer,Clay-Dough,84189600,63886,2984,60902,2022-09-03
2035,Disney Studios,E-Commerce,Clay-Dough,68637421,63874,43200,20674,2022-02-25
3718,TikTok Inc,E-Commerce,Transmorphers,52635948,63863,24042,39821,2022-08-11
430,TikTok Inc,Media Supported Asset,Clay-Dough,57188040,63861,12467,51394,2022-12-09
4914,Pinterest Inc,Brand Publicity,GI-Bro,87084779,63855,5032,58823,2022-12-15
544,Pinterest Inc,E-Commerce,Clay-Dough,22433036,63814,9952,53862,2022-10-15
2061,KYG Antler LLC,E-Commerce,Transmorphers,94909894,63811,8314,55497,2022-06-30
4424,Disney Studios,Influencer,Clay-Dough,81597220,63809,42017,21792,2022-02-09
1506,Nintendo Technologies,Influencer,Space Wars,65783445,63731,2687,61044,2022-07-20
97,Meta Platforms,E-Commerce,Space Wars,45051320,63684,52545,11139,2022-05-04
2466,Disney Studios,Media Supported Asset,Transmorphers,47588267,63681,58320,5361,2022-03-21
4355,The Martingale Agency,Brand Publicity,Transmorphers,33131277,63638,42609,21029,2022-03-17
719,KYG Antler LLC,Brand Publicity,Clay-Dough,20717023,63628,57000,6628,2022-05-20
773,Pinterest Inc,E-Commerce,Space Wars,43098863,63624,5195,58429,2022-10-06
2220,Google Inc.,Brand Publicity,Transmorphers,29197626,63615,38898,24717,2022-06-15
728,The Martingale Agency,E-Commerce,Transmorphers,13275248,63611,22547,41064,2022-01-10
369,Disney Studios,Brand Asset Development,Space Wars,53717593,63591,31252,32339,2022-03-22
379,Meta Platforms,Media Supported Asset,GI-Bro,30385821,63584,12810,50774,2022-11-17
1776,Google Inc.,Brand Publicity,GI-Bro,74867820,63582,117,63465,2022-11-02
3605,Google Inc.,Media Supported Asset,Transmorphers,25915659,63567,20569,42998,2022-07-01
4983,Meta Platforms,E-Commerce,GI-Bro,54484410,63552,49391,14161,2022-01-30
4790,Nintendo Technologies,Media Supported Asset,Merf,83274606,63547,27068,36479,2022-07-03
3896,Disney Studios,Brand Publicity,Space Wars,75903607,63477,30996,32481,2022-09-22
724,Disney Studios,E-Commerce,Transmorphers,81185790,63468,15826,47642,2022-04-23
90,Disney Studios,E-Commerce,GI-Bro,13644331,63447,37198,26249,2022-07-25
1557,Pinterest Inc,Influencer,Transmorphers,69737773,63444,7326,56118,2022-12-18
1921,TikTok Inc,Brand Publicity,Clay-Dough,51472793,63416,5027,58389,2022-09-06
4712,Google Inc.,Influencer,Transmorphers,13144007,63409,22260,41149,2022-07-26
3514,Google Inc.,E-Commerce,Merf,45933668,63394,24590,38804,2022-09-11
3491,Pinterest Inc,Influencer,Space Wars,89326426,63386,5084,58302,2022-06-28
3371,TikTok Inc,Brand Asset Development,Clay-Dough,18153393,63383,8626,54757,2022-12-02
4415,The Martingale Agency,Media Supported Asset,Clay-Dough,14945250,63329,4014,59315,2022-05-26
4162,The Martingale Agency,Brand Asset Development,Transmorphers,30344479,63323,11049,52274,2022-08-12
3862,Meta Platforms,Brand Asset Development,Space Wars,39602777,63314,11481,51833,2022-10-17
936,Google Inc.,Brand Asset Development,Transmorphers,29430424,63310,6829,56481,2022-10-27
3782,Disney Studios,Brand Publicity,GI-Bro,57748262,63307,23344,39963,2022-09-12
2868,The Martingale Agency,Brand Publicity,GI-Bro,18390213,63299,4553,58746,2022-10-15
1231,KYG Antler LLC,Brand Asset Development,Merf,88280539,63284,7795,55489,2022-07-18
4046,Nintendo Technologies,Media Supported Asset,Clay-Dough,21845651,63280,842,62438,2022-02-07
1965,KYG Antler LLC,E-Commerce,Clay-Dough,60162306,63278,1016,62262,2022-10-01
598,Meta Platforms,E-Commerce,Clay-Dough,80351451,63255,36446,26809,2022-01-31
2911,Disney Studios,Brand Publicity,Space Wars,78456761,63251,49040,14211,2022-01-08
4146,Disney Studios,E-Commerce,Merf,68116463,63246,2327,60919,2022-11-30
4645,TikTok Inc,Influencer,Merf,42829958,63233,38319,24914,2022-01-25
4144,KYG Antler LLC,Brand Publicity,GI-Bro,53491779,63219,6707,56512,2022-07-24
558,TikTok Inc,Brand Publicity,Clay-Dough,89857032,63216,46720,16496,2022-03-11
237,Meta Platforms,Media Supported Asset,Merf,73805463,63212,1797,61415,2022-11-02
3028,Meta Platforms,Media Supported Asset,GI-Bro,34549378,63208,7778,55430,2022-03-31
3438,TikTok Inc,E-Commerce,Merf,13696378,63197,26602,36595,2022-09-22
3374,KYG Antler LLC,Influencer,Space Wars,95240411,63170,517,62653,2022-09-07
4993,Nintendo Technologies,Brand Publicity,Transmorphers,68196853,63161,21553,41608,2022-01-09
1205,Google Inc.,E-Commerce,Space Wars,47004566,63159,8047,55112,2022-08-30
385,KYG Antler LLC,E-Commerce,GI-Bro,73511336,63152,58314,4838,2022-01-23
409,The Martingale Agency,Influencer,GI-Bro,41374782,63119,2565,60554,2022-11-25
1391,Pinterest Inc,Influencer,GI-Bro,48402607,63098,36353,26745,2022-03-02
2970,Google Inc.,Brand Asset Development,Space Wars,95420929,63070,49472,13598,2022-01-05
1328,Disney Studios,E-Commerce,Merf,60990506,63056,7039,56017,2022-11-15
2363,Pinterest Inc,Brand Publicity,Merf,57275885,63051,60522,2529,2022-06-03
3920,Google Inc.,Brand Publicity,Transmorphers,53073948,63048,61543,1505,2022-01-25
3158,Disney Studios,Brand Asset Development,Clay-Dough,31393972,63039,26947,36092,2022-05-19
3198,Meta Platforms,Influencer,Merf,20617235,63029,8025,55004,2022-11-20
451,Disney Studios,Brand Publicity,Space Wars,50230974,63025,20682,42343,2022-07-14
1252,Pinterest Inc,Brand Asset Development,Clay-Dough,73692122,63015,9904,53111,2022-11-15
1577,Google Inc.,Media Supported Asset,Merf,35247801,62992,27753,35239,2022-05-26
2154,Pinterest Inc,E-Commerce,Space Wars,27585442,62947,62038,909,2022-06-04
969,Google Inc.,Brand Publicity,Transmorphers,92383460,62841,9237,53604,2022-04-01
3206,Pinterest Inc,E-Commerce,Transmorphers,51409047,62834,3451,59383,2022-10-20
1888,Meta Platforms,Brand Publicity,Clay-Dough,87953175,62751,47256,15495,2022-03-01
4900,The Martingale Agency,Media Supported Asset,Merf,91670160,62749,47724,15025,2022-04-09
3530,Pinterest Inc,Influencer,Transmorphers,67183154,62730,22768,39962,2022-07-28
3267,Nintendo Technologies,Brand Publicity,Merf,74795281,62722,26463,36259,2022-06-21
52,TikTok Inc,Brand Publicity,Transmorphers,69646279,62717,21536,41181,2022-07-13
1778,TikTok Inc,E-Commerce,Space Wars,89540307,62703,9835,52868,2022-12-04
766,TikTok Inc,Media Supported Asset,Transmorphers,12188519,62702,43263,19439,2022-03-13
3773,Meta Platforms,Influencer,Clay-Dough,22464563,62685,36564,26121,2022-04-02
1757,Disney Studios,E-Commerce,Clay-Dough,40558298,62668,58125,4543,2022-06-22
2279,Google Inc.,Brand Publicity,Merf,85093235,62664,20551,42113,2022-08-04
3228,TikTok Inc,Brand Publicity,Merf,75273651,62645,1207,61438,2022-02-03
1764,Disney Studios,Brand Asset Development,GI-Bro,90839646,62633,3323,59310,2022-12-05
2684,Nintendo Technologies,Brand Publicity,Transmorphers,13663262,62597,32749,29848,2022-09-30
1222,TikTok Inc,Media Supported Asset,Space Wars,48012658,62547,11756,50791,2022-12-13
2454,Google Inc.,Influencer,GI-Bro,97274405,62530,8838,53692,2022-12-06
4916,KYG Antler LLC,E-Commerce,GI-Bro,27051854,62510,23256,39254,2022-04-27
1380,Nintendo Technologies,Brand Publicity,Transmorphers,37438713,62449,5852,56597,2022-06-03
974,Google Inc.,Brand Publicity,Clay-Dough,53413538,62447,52256,10191,2022-04-06
1132,The Martingale Agency,Brand Asset Development,GI-Bro,45960675,62442,38481,23961,2022-04-21
1070,Disney Studios,Brand Publicity,Space Wars,47369538,62432,2821,59611,2022-02-23
1524,TikTok Inc,Media Supported Asset,GI-Bro,49256598,62321,45487,16834,2022-01-21
1446,KYG Antler LLC,Influencer,Merf,89572695,62294,35103,27191,2022-04-07
326,TikTok Inc,Brand Asset Development,Transmorphers,56790530,62285,4021,58264,2022-10-27
4248,Meta Platforms,Media Supported Asset,Clay-Dough,19570471,62272,20706,41566,2022-01-16
3637,Meta Platforms,Influencer,Space Wars,12851639,62258,16465,45793,2022-02-05
1412,Disney Studios,E-Commerce,Merf,32759500,62248,56009,6239,2022-05-22
3412,Nintendo Technologies,Brand Asset Development,Merf,86938660,62246,3604,58642,2022-07-05
755,Meta Platforms,Media Supported Asset,Transmorphers,83146357,62243,37351,24892,2022-06-28
1085,Google Inc.,Influencer,Merf,95732253,62233,14484,47749,2022-06-18
614,Google Inc.,Brand Publicity,Clay-Dough,76311932,62216,10236,51980,2022-12-27
121,TikTok Inc,Media Supported Asset,Space Wars,57992382,62184,54035,8149,2022-05-03
1490,Disney Studios,E-Commerce,GI-Bro,36370230,62140,28007,34133,2022-01-05
651,KYG Antler LLC,E-Commerce,Clay-Dough,13480744,62131,58802,3329,2022-04-19
2435,Google Inc.,Media Supported Asset,Merf,40775236,62095,2245,59850,2022-12-10
3225,Google Inc.,Brand Asset Development,Space Wars,49648747,62074,38640,23434,2022-06-12
3818,Pinterest Inc,Influencer,GI-Bro,73288523,62047,3960,58087,2022-11-06
4599,The Martingale Agency,E-Commerce,Clay-Dough,86117375,62027,33862,28165,2022-03-01
4650,Pinterest Inc,Influencer,Space Wars,36115494,61968,4623,57345,2022-11-16
3780,Meta Platforms,Influencer,Clay-Dough,41781400,61920,11768,50152,2022-11-14
59,KYG Antler LLC,E-Commerce,Merf,20957734,61909,19027,42882,2022-08-11
1949,TikTok Inc,E-Commerce,GI-Bro,23792235,61865,40601,21264,2022-05-01
298,Nintendo Technologies,E-Commerce,Clay-Dough,51776336,61845,59524,2321,2022-01-13
1155,Pinterest Inc,Brand Asset Development,Merf,24034748,61840,9274,52566,2022-04-03
1976,Pinterest Inc,Brand Asset Development,Clay-Dough,33490517,61836,46091,15745,2022-05-24
4788,TikTok Inc,E-Commerce,GI-Bro,98817907,61830,45234,16596,2022-06-18
376,Disney Studios,E-Commerce,Transmorphers,19159489,61789,29946,31843,2022-03-05
2592,The Martingale Agency,Influencer,Space Wars,57627690,61745,51078,10667,2022-04-20
4196,Disney Studios,Media Supported Asset,Merf,78050870,61731,8995,52736,2022-10-30
592,Nintendo Technologies,Media Supported Asset,Transmorphers,79727181,61723,12731,48992,2022-08-24
1918,KYG Antler LLC,Media Supported Asset,Clay-Dough,17539631,61689,5231,56458,2022-11-14
3744,KYG Antler LLC,Media Supported Asset,Merf,97384508,61669,7775,53894,2022-09-22
2174,KYG Antler LLC,Brand Publicity,Clay-Dough,47532178,61634,61573,61,2022-03-31
4545,Google Inc.,E-Commerce,Merf,50681968,61616,4794,56822,2022-11-01
1108,Google Inc.,Brand Asset Development,Merf,38809512,61613,57804,3809,2022-04-19
3987,TikTok Inc,Media Supported Asset,Clay-Dough,26032657,61610,9611,51999,2022-10-08
2677,Google Inc.,Brand Publicity,Merf,68461964,61594,21807,39787,2022-06-01
319,Disney Studios,Brand Publicity,Clay-Dough,14294510,61568,48343,13225,2022-03-12
2808,KYG Antler LLC,Media Supported Asset,Clay-Dough,83659560,61556,22905,38651,2022-03-02
4858,Google Inc.,Brand Asset Development,Clay-Dough,17517029,61543,11021,50522,2022-10-03
882,Pinterest Inc,Media Supported Asset,Merf,52120219,61523,31349,30174,2022-06-16
4735,Nintendo Technologies,Brand Asset Development,Space Wars,45000201,61516,37053,24463,2022-02-02
3468,KYG Antler LLC,Influencer,Transmorphers,67632446,61493,44337,17156,2022-04-21
3848,KYG Antler LLC,E-Commerce,Merf,35205868,61486,9804,51682,2022-06-02
218,Pinterest Inc,Media Supported Asset,Clay-Dough,25591923,61431,2724,58707,2022-12-22
611,Nintendo Technologies,Brand Asset Development,Space Wars,87947401,61420,9046,52374,2022-10-10
4328,Google Inc.,E-Commerce,GI-Bro,61864887,61418,14995,46423,2022-08-19
2166,KYG Antler LLC,Influencer,GI-Bro,83375986,61415,9143,52272,2022-10-17
2285,Nintendo Technologies,Brand Publicity,Transmorphers,92604955,61395,1347,60048,2022-10-22
1704,TikTok Inc,Influencer,Merf,25086395,61373,4953,56420,2022-10-24
3119,KYG Antler LLC,Influencer,Merf,60733070,61361,46031,15330,2022-02-15
4083,Nintendo Technologies,E-Commerce,Merf,70407172,61350,30859,30491,2022-03-22
3278,KYG Antler LLC,Media Supported Asset,GI-Bro,27390164,61337,3075,58262,2022-06-29
2233,Google Inc.,E-Commerce,Transmorphers,53713412,61330,12753,48577,2022-03-26
1082,Nintendo Technologies,Media Supported Asset,Transmorphers,77082893,61324,16745,44579,2022-04-21
4440,Pinterest Inc,E-Commerce,Clay-Dough,91298804,61317,22565,38752,2022-08-19
521,Google Inc.,Brand Asset Development,Space Wars,20261166,61286,9672,51614,2022-09-10
768,Meta Platforms,Brand Publicity,Space Wars,40472738,61261,15932,45329,2022-05-07
3112,TikTok Inc,E-Commerce,Transmorphers,63388790,61190,2216,58974,2022-12-12
502,TikTok Inc,E-Commerce,Space Wars,82025701,61167,16123,45044,2022-08-24
2143,The Martingale Agency,Brand Asset Development,Space Wars,15209196,61163,8313,52850,2022-11-16
148,TikTok Inc,E-Commerce,Space Wars,65364887,61151,2336,58815,2022-12-22
3012,Pinterest Inc,E-Commerce,GI-Bro,78611512,61100,40509,20591,2022-05-08
2914,Nintendo Technologies,Media Supported Asset,Merf,58827070,61060,5522,55538,2022-10-14
1875,The Martingale Agency,Influencer,Space Wars,96241502,61018,6028,54990,2022-11-30
1855,Pinterest Inc,Influencer,GI-Bro,69210847,61000,28397,32603,2022-06-26
531,TikTok Inc,Influencer,GI-Bro,92325672,60969,5990,54979,2022-11-20
2172,TikTok Inc,E-Commerce,Space Wars,96576095,60963,19218,41745,2022-02-04
3543,Disney Studios,Media Supported Asset,Merf,40036674,60959,27489,33470,2022-08-29
3511,The Martingale Agency,Media Supported Asset,Space Wars,52956722,60945,19039,41906,2022-06-06
2922,KYG Antler LLC,E-Commerce,Transmorphers,41323839,60922,21406,39516,2022-09-22
1951,Nintendo Technologies,E-Commerce,Merf,32420196,60912,122,60790,2022-10-16
4200,Pinterest Inc,Media Supported Asset,Transmorphers,69929881,60894,44871,16023,2022-04-12
3557,The Martingale Agency,Brand Publicity,Transmorphers,81797993,60878,1515,59363,2022-11-10
2988,Nintendo Technologies,Influencer,Merf,25393713,60875,806,60069,2022-10-06
2405,Disney Studios,Influencer,Merf,29257036,60817,3279,57538,2022-12-28
1945,Meta Platforms,Media Supported Asset,Transmorphers,40389729,60804,15822,44982,2022-08-17
1654,Meta Platforms,Influencer,GI-Bro,89930941,60735,10535,50200,2022-04-04
2857,Google Inc.,Media Supported Asset,Transmorphers,70460700,60714,1024,59690,2022-10-27
235,Pinterest Inc,Influencer,GI-Bro,17742698,60680,23514,37166,2022-08-26
1899,Nintendo Technologies,Media Supported Asset,Space Wars,74944660,60677,47268,13409,2022-06-08
4663,KYG Antler LLC,Brand Asset Development,GI-Bro,24103898,60635,12894,47741,2022-02-13
3231,KYG Antler LLC,E-Commerce,Merf,47096965,60634,48452,12182,2022-02-28
1495,Meta Platforms,Influencer,GI-Bro,82002702,60625,60404,221,2022-03-17
4727,Nintendo Technologies,Brand Asset Development,Space Wars,90039966,60599,9906,50693,2022-07-26
4455,Meta Platforms,Brand Asset Development,Space Wars,95369749,60567,16430,44137,2022-05-27
505,Disney Studios,Brand Publicity,Transmorphers,28042187,60567,16870,43697,2022-09-12
4090,Pinterest Inc,Influencer,Merf,82791087,60559,56976,3583,2022-04-16
4188,KYG Antler LLC,Media Supported Asset,GI-Bro,36199990,60502,54884,5618,2022-04-21
4366,Pinterest Inc,Brand Asset Development,Space Wars,31987009,60497,52608,7889,2022-01-18
4249,TikTok Inc,Brand Asset Development,Clay-Dough,37130508,60450,2660,57790,2022-03-30
3398,TikTok Inc,Brand Publicity,Clay-Dough,83071550,60431,22197,38234,2022-05-17
1531,The Martingale Agency,Brand Publicity,Transmorphers,86988318,60421,30193,30228,2022-08-11
3281,The Martingale Agency,Brand Publicity,Space Wars,66360482,60413,5566,54847,2022-01-26
813,Pinterest Inc,E-Commerce,GI-Bro,99945409,60375,47390,12985,2022-05-21
3995,Meta Platforms,E-Commerce,Clay-Dough,57774510,60356,31758,28598,2022-03-19
3167,TikTok Inc,Brand Publicity,Merf,19868483,60353,2874,57479,2022-08-01
4259,TikTok Inc,E-Commerce,GI-Bro,95384786,60281,2841,57440,2022-12-18
4962,TikTok Inc,Influencer,Transmorphers,94920226,60271,4688,55583,2022-12-24
1546,Meta Platforms,Media Supported Asset,Clay-Dough,60602117,60262,23591,36671,2022-08-28
2246,KYG Antler LLC,Influencer,Clay-Dough,66050975,60233,34468,25765,2022-01-19
54,Meta Platforms,Brand Publicity,GI-Bro,52735152,60186,34042,26144,2022-08-22
4433,Pinterest Inc,E-Commerce,Merf,47764486,60052,317,59735,2022-01-27
933,The Martingale Agency,Media Supported Asset,Merf,25434299,60046,49285,10761,2022-06-12
3280,Pinterest Inc,Media Supported Asset,Merf,35242607,60029,9097,50932,2022-12-23
2667,Meta Platforms,Brand Publicity,GI-Bro,80951837,59996,1095,58901,2022-11-22
1672,KYG Antler LLC,Media Supported Asset,Clay-Dough,45063796,59982,5786,54196,2022-10-08
2055,Google Inc.,Brand Asset Development,GI-Bro,57154222,59974,870,59104,2022-11-07
1691,KYG Antler LLC,Brand Publicity,Merf,91093256,59962,54013,5949,2022-06-10
4907,Disney Studios,Brand Publicity,Space Wars,87743593,59950,206,59744,2022-10-03
2357,Meta Platforms,Media Supported Asset,Space Wars,54183575,59902,16900,43002,2022-09-19
894,The Martingale Agency,E-Commerce,Transmorphers,48582075,59882,29777,30105,2022-05-18
3477,TikTok Inc,E-Commerce,Space Wars,51080875,59860,30125,29735,2022-05-29
1692,Google Inc.,Influencer,Transmorphers,18548583,59839,604,59235,2022-11-20
4899,Pinterest Inc,Influencer,Space Wars,60913696,59830,54619,5211,2022-02-22
3413,Disney Studios,Brand Publicity,Merf,15399489,59816,36825,22991,2022-01-18
4215,Meta Platforms,Media Supported Asset,Transmorphers,23584409,59759,4799,54960,2022-08-22
4997,Nintendo Technologies,Influencer,Transmorphers,51114366,59695,8999,50696,2022-11-07
645,The Martingale Agency,Brand Publicity,Space Wars,66965426,59630,7073,52557,2022-11-06
279,The Martingale Agency,E-Commerce,Space Wars,46320505,59607,5905,53702,2022-12-13
4676,Meta Platforms,E-Commerce,GI-Bro,51426919,59598,33072,26526,2022-01-17
2916,TikTok Inc,Brand Asset Development,Transmorphers,96755653,59576,8698,50878,2022-08-14
384,Pinterest Inc,Brand Asset Development,GI-Bro,43161557,59562,13311,46251,2022-07-29
4102,KYG Antler LLC,Brand Asset Development,Transmorphers,38477605,59550,6358,53192,2022-12-23
1582,Google Inc.,Influencer,Clay-Dough,47466692,59541,33121,26420,2022-09-15
4275,Google Inc.,Media Supported Asset,Merf,19909336,59521,5429,54092,2022-03-01
4799,TikTok Inc,E-Commerce,Transmorphers,55042676,59501,22875,36626,2022-03-24
4334,TikTok Inc,Influencer,Transmorphers,43457728,59431,4600,54831,2022-10-10
2746,Google Inc.,Media Supported Asset,Transmorphers,48658219,59386,4621,54765,2022-01-11
3700,Meta Platforms,Influencer,Clay-Dough,23627071,59330,13864,45466,2022-03-15
2269,The Martingale Agency,Brand Asset Development,Space Wars,98866928,59326,1333,57993,2022-11-21
306,Disney Studios,Influencer,GI-Bro,42223435,59266,54268,4998,2022-05-19
64,Pinterest Inc,Influencer,GI-Bro,63165092,59249,29445,29804,2022-03-29
362,Google Inc.,Media Supported Asset,GI-Bro,24659696,59238,52692,6546,2022-01-01
2693,Pinterest Inc,Influencer,Space Wars,31148781,59225,7139,52086,2022-10-26
1955,Google Inc.,Brand Publicity,GI-Bro,24367108,59201,41781,17420,2022-02-04
199,Google Inc.,Brand Asset Development,Space Wars,40148636,59160,5720,53440,2022-09-20
1313,Google Inc.,Brand Asset Development,Clay-Dough,84240381,59155,58261,894,2022-02-11
1394,Disney Studios,Influencer,Merf,66089101,59107,12569,46538,2022-02-17
4269,The Martingale Agency,Brand Asset Development,Transmorphers,40867020,59092,27785,31307,2022-06-30
2301,Disney Studios,Brand Publicity,Merf,10703073,59088,10213,48875,2022-01-30
2975,Meta Platforms,Brand Asset Development,Transmorphers,36066692,59086,30052,29034,2022-07-02
2664,Pinterest Inc,Brand Publicity,Merf,35653365,59071,7155,51916,2022-04-14
1159,KYG Antler LLC,Brand Asset Development,Transmorphers,78341961,59063,912,58151,2022-04-24
476,Google Inc.,Brand Asset Development,Transmorphers,74497359,59059,349,58710,2022-11-18
316,Pinterest Inc,E-Commerce,GI-Bro,69887978,59044,27588,31456,2022-06-25
4491,Nintendo Technologies,Brand Publicity,GI-Bro,92729431,59020,37163,21857,2022-06-17
1435,Google Inc.,Influencer,Space Wars,74798207,58977,16948,42029,2022-08-03
4142,KYG Antler LLC,Brand Publicity,Transmorphers,63683418,58977,32636,26341,2022-04-25
127,Google Inc.,Media Supported Asset,Transmorphers,35300297,58974,30052,28922,2022-09-07
4765,Nintendo Technologies,E-Commerce,GI-Bro,27145296,58952,6454,52498,2022-02-07
774,TikTok Inc,E-Commerce,Space Wars,93673114,58951,25170,33781,2022-09-10
1291,Google Inc.,Brand Asset Development,Transmorphers,65397983,58902,12217,46685,2022-07-14
1956,Meta Platforms,E-Commerce,GI-Bro,95756990,58840,882,57958,2022-08-24
2378,Meta Platforms,Influencer,Merf,27828415,58818,39972,18846,2022-06-21
3979,Google Inc.,E-Commerce,Transmorphers,29973758,58801,22076,36725,2022-08-29
4257,The Martingale Agency,Brand Asset Development,Merf,90234552,58797,287,58510,2022-09-14
4114,Pinterest Inc,Media Supported Asset,Transmorphers,41188958,58792,2051,56741,2022-11-27
1452,TikTok Inc,Brand Asset Development,Space Wars,21915677,58752,23053,35699,2022-06-21
947,Google Inc.,Brand Asset Development,Merf,94780944,58742,49961,8781,2022-02-09
1335,Meta Platforms,Brand Asset Development,Transmorphers,16052387,58740,54618,4122,2022-05-18
867,Meta Platforms,Media Supported Asset,Clay-Dough,53797833,58730,31124,27606,2022-04-02
1306,Nintendo Technologies,Influencer,Clay-Dough,18461740,58712,7790,50922,2022-09-14
1374,Nintendo Technologies,Influencer,Space Wars,89727412,58683,3051,55632,2022-11-27
1826,Disney Studios,E-Commerce,GI-Bro,15988179,58677,2342,56335,2022-06-02
593,Meta Platforms,Influencer,GI-Bro,51970887,58669,7969,50700,2022-10-04
3607,Pinterest Inc,Media Supported Asset,Merf,56759759,58664,2547,56117,2022-11-25
1117,Google Inc.,Brand Asset Development,Transmorphers,60808003,58663,7953,50710,2022-11-08
3382,Pinterest Inc,Brand Asset Development,Space Wars,94083925,58658,13519,45139,2022-03-22
4812,The Martingale Agency,E-Commerce,GI-Bro,78489683,58656,29538,29118,2022-03-30
2876,Meta Platforms,Brand Asset Development,Merf,39967432,58617,16300,42317,2022-06-08
2883,Google Inc.,Influencer,GI-Bro,27665867,58613,48741,9872,2022-04-20
3348,Disney Studios,Media Supported Asset,Clay-Dough,90274675,58601,50165,8436,2022-06-23
1486,KYG Antler LLC,Brand Asset Development,Transmorphers,61291964,58597,22476,36121,2022-03-05
4802,KYG Antler LLC,E-Commerce,Space Wars,95839907,58590,30344,28246,2022-08-06
2090,Pinterest Inc,E-Commerce,GI-Bro,78378444,58581,27656,30925,2022-09-30
1762,Google Inc.,Brand Asset Development,Clay-Dough,38840388,58471,6394,52077,2022-12-08
1336,Disney Studios,E-Commerce,GI-Bro,19673961,58441,3277,55164,2022-03-08
1254,KYG Antler LLC,Brand Asset Development,Space Wars,35650754,58425,4877,53548,2022-12-09
4475,Pinterest Inc,Brand Asset Development,Clay-Dough,93026713,58404,21148,37256,2022-09-24
2230,Meta Platforms,E-Commerce,GI-Bro,15061785,58371,46374,11997,2022-04-02
4295,Meta Platforms,Brand Asset Development,Space Wars,92015278,58371,804,57567,2022-10-07
2021,The Martingale Agency,Media Supported Asset,GI-Bro,65977027,58367,44679,13688,2022-03-18
3209,Google Inc.,Media Supported Asset,Merf,19147845,58359,23748,34611,2022-07-16
3191,Pinterest Inc,Brand Publicity,GI-Bro,87372107,58318,5709,52609,2022-08-18
1710,The Martingale Agency,E-Commerce,Space Wars,38805751,58283,8948,49335,2022-07-03
1930,Nintendo Technologies,Media Supported Asset,Transmorphers,72979956,58193,14882,43311,2022-04-12
1475,The Martingale Agency,Media Supported Asset,Clay-Dough,71432644,58145,15649,42496,2022-03-08
4745,TikTok Inc,Brand Asset Development,GI-Bro,61345112,58141,1043,57098,2022-10-15
2197,Disney Studios,Brand Asset Development,GI-Bro,20855489,58099,6576,51523,2022-09-08
2273,Nintendo Technologies,Brand Publicity,GI-Bro,90343531,58095,22075,36020,2022-07-25
3070,TikTok Inc,Brand Publicity,Merf,22868969,58080,5791,52289,2022-10-12
4791,Nintendo Technologies,Influencer,Transmorphers,65117435,58079,1288,56791,2022-12-27
1819,Disney Studios,Influencer,GI-Bro,60966264,58053,19887,38166,2022-03-12
4852,Meta Platforms,Influencer,GI-Bro,69248121,58053,389,57664,2022-01-19
603,Pinterest Inc,E-Commerce,GI-Bro,28314141,58040,49521,8519,2022-03-10
3838,Nintendo Technologies,Brand Asset Development,Clay-Dough,10230033,58022,8442,49580,2022-06-19
3945,KYG Antler LLC,Brand Publicity,Space Wars,79446924,57961,35283,22678,2022-06-17
1191,Disney Studios,E-Commerce,Transmorphers,15840246,57930,20342,37588,2022-08-21
2648,Pinterest Inc,Media Supported Asset,GI-Bro,34411632,57902,18985,38917,2022-08-14
3241,Google Inc.,Media Supported Asset,GI-Bro,82940766,57892,6179,51713,2022-12-05
1198,Nintendo Technologies,Media Supported Asset,Space Wars,97956023,57877,5843,52034,2022-11-02
1508,Google Inc.,Influencer,Space Wars,79484030,57859,2823,55036,2022-09-07
4906,Disney Studios,Media Supported Asset,GI-Bro,45792426,57850,2307,55543,2022-10-31
3472,Google Inc.,Media Supported Asset,Merf,54642036,57820,22955,34865,2022-06-15
520,Disney Studios,Media Supported Asset,Merf,83830384,57800,24024,33776,2022-09-19
1774,Meta Platforms,E-Commerce,Clay-Dough,24093121,57800,18641,39159,2022-09-19
2767,The Martingale Agency,Brand Publicity,GI-Bro,62464224,57797,3386,54411,2022-11-06
1180,Meta Platforms,Influencer,Clay-Dough,47856815,57784,2436,55348,2022-10-05
1814,TikTok Inc,Influencer,Space Wars,38198073,57771,3905,53866,2022-10-19
3586,Google Inc.,E-Commerce,Space Wars,76804689,57770,40096,17674,2022-03-03
2461,Google Inc.,E-Commerce,Clay-Dough,87288072,57738,40626,17112,2022-06-17
1359,Pinterest Inc,Brand Asset Development,Space Wars,95942120,57737,3844,53893,2022-08-17
2952,TikTok Inc,Brand Asset Development,Merf,37830026,57736,18047,39689,2022-06-01
4118,The Martingale Agency,E-Commerce,Merf,24214905,57735,16307,41428,2022-08-11
610,Disney Studios,Brand Publicity,Merf,93571247,57729,22589,35140,2022-07-07
2521,Disney Studios,E-Commerce,GI-Bro,65501324,57727,31896,25831,2022-02-14
4519,The Martingale Agency,Influencer,GI-Bro,56418575,57694,17019,40675,2022-05-14
4888,TikTok Inc,Media Supported Asset,GI-Bro,73957787,57690,1312,56378,2022-12-18
2995,The Martingale Agency,Influencer,Clay-Dough,15080900,57675,21701,35974,2022-02-01
2598,The Martingale Agency,Brand Asset Development,GI-Bro,18608841,57674,6863,50811,2022-10-16
2790,Google Inc.,Influencer,GI-Bro,10480632,57639,21015,36624,2022-07-05
665,Nintendo Technologies,Media Supported Asset,Merf,51635413,57635,5918,51717,2022-10-11
1042,Meta Platforms,Brand Asset Development,Clay-Dough,26627180,57626,5480,52146,2022-10-06
4031,KYG Antler LLC,Media Supported Asset,Merf,64276665,57613,4851,52762,2022-11-23
1608,The Martingale Agency,Brand Publicity,Clay-Dough,43869709,57585,4767,52818,2022-12-03
157,KYG Antler LLC,Media Supported Asset,Transmorphers,67268663,57567,16476,41091,2022-03-20
1448,Pinterest Inc,Brand Asset Development,Transmorphers,98287363,57567,15155,42412,2022-06-04
1835,KYG Antler LLC,Media Supported Asset,Transmorphers,28527531,57556,26571,30985,2022-02-28
3846,Disney Studios,Media Supported Asset,GI-Bro,90783147,57538,12273,45265,2022-09-03
1337,KYG Antler LLC,Media Supported Asset,Merf,21691256,57496,3375,54121,2022-12-25
4377,Disney Studios,E-Commerce,GI-Bro,85803374,57480,9148,48332,2022-03-22
1403,Disney Studios,Media Supported Asset,Clay-Dough,95248504,57475,50262,7213,2022-01-08
4155,The Martingale Agency,Influencer,Space Wars,42688242,57459,8747,48712,2022-08-02
1480,Google Inc.,Media Supported Asset,Transmorphers,28895026,57438,13804,43634,2022-02-13
4651,Meta Platforms,E-Commerce,GI-Bro,47323750,57407,37630,19777,2022-01-06
3124,TikTok Inc,Influencer,Clay-Dough,58255184,57396,2216,55180,2022-11-29
528,Google Inc.,Brand Asset Development,Transmorphers,95845716,57384,19308,38076,2022-06-30
4106,KYG Antler LLC,Brand Publicity,Transmorphers,70246957,57384,4760,52624,2022-02-06
1642,Nintendo Technologies,E-Commerce,Transmorphers,91711488,57368,30283,27085,2022-07-18
3359,Pinterest Inc,Brand Asset Development,GI-Bro,17179763,57366,36069,21297,2022-03-05
89,Pinterest Inc,Brand Asset Development,Clay-Dough,83407353,57361,18386,38975,2022-01-26
4497,Google Inc.,Brand Asset Development,Clay-Dough,10940224,57353,35790,21563,2022-03-15
2925,Meta Platforms,E-Commerce,Clay-Dough,44468783,57349,5315,52034,2022-12-11
4798,KYG Antler LLC,Influencer,Clay-Dough,14834503,57341,3161,54180,2022-10-13
2805,The Martingale Agency,E-Commerce,Space Wars,41013409,57334,9195,48139,2022-02-18
449,KYG Antler LLC,Influencer,Transmorphers,18741755,57318,27555,29763,2022-08-18
2229,The Martingale Agency,Brand Asset Development,Space Wars,86598148,57290,4640,52650,2022-12-08
344,Disney Studios,Brand Publicity,Clay-Dough,36290109,57210,1348,55862,2022-10-27
486,Meta Platforms,Brand Asset Development,Clay-Dough,22833937,57177,22024,35153,2022-07-05
2884,TikTok Inc,Brand Publicity,Merf,78040248,57124,5427,51697,2022-12-17
2732,Meta Platforms,E-Commerce,Space Wars,23901630,57100,26171,30929,2022-04-08
186,Meta Platforms,Media Supported Asset,Transmorphers,70408876,57028,1182,55846,2022-01-30
721,Disney Studios,Media Supported Asset,GI-Bro,93349506,57023,9562,47461,2022-03-28
956,The Martingale Agency,Media Supported Asset,Clay-Dough,70146483,57003,10731,46272,2022-06-02
3014,KYG Antler LLC,Influencer,Merf,33127439,57000,7124,49876,2022-07-24
2668,Nintendo Technologies,Media Supported Asset,GI-Bro,41798823,56999,1137,55862,2022-12-18
2340,Google Inc.,Influencer,Transmorphers,44073425,56992,2558,54434,2022-05-24
827,TikTok Inc,Influencer,Clay-Dough,32053441,56986,11596,45390,2022-04-05
4591,KYG Antler LLC,Brand Asset Development,GI-Bro,23373913,56977,5800,51177,2022-10-08
925,Nintendo Technologies,Brand Publicity,GI-Bro,97512125,56954,43487,13467,2022-03-17
2289,TikTok Inc,Brand Asset Development,Clay-Dough,46574884,56919,31467,25452,2022-04-27
958,Meta Platforms,Brand Asset Development,Space Wars,68519820,56891,53643,3248,2022-01-27
2343,KYG Antler LLC,E-Commerce,GI-Bro,32411297,56886,13599,43287,2022-09-07
1803,KYG Antler LLC,Brand Publicity,Transmorphers,53974355,56881,25632,31249,2022-09-16
707,Disney Studios,E-Commerce,Clay-Dough,27507588,56855,2276,54579,2022-12-02
1256,Meta Platforms,Influencer,GI-Bro,18958441,56854,3624,53230,2022-10-01
621,Disney Studios,Brand Publicity,Transmorphers,58811549,56756,47880,8876,2022-01-07
1983,Google Inc.,Brand Asset Development,Transmorphers,33935250,56733,5892,50841,2022-09-05
2875,KYG Antler LLC,Brand Publicity,GI-Bro,70895638,56722,46236,10486,2022-06-29
3886,Disney Studios,Media Supported Asset,Merf,48712746,56699,12881,43818,2022-09-16
3386,The Martingale Agency,E-Commerce,GI-Bro,24508000,56688,4737,51951,2022-11-22
2323,KYG Antler LLC,Brand Asset Development,Space Wars,37538252,56686,20131,36555,2022-03-06
3027,Nintendo Technologies,Media Supported Asset,Clay-Dough,68355729,56664,7696,48968,2022-09-20
4557,Meta Platforms,Brand Publicity,Merf,91253121,56611,1272,55339,2022-05-16
4789,Meta Platforms,Brand Asset Development,Transmorphers,25084802,56532,21876,34656,2022-09-13
4087,The Martingale Agency,Influencer,Merf,33413082,56517,23314,33203,2022-08-06
3149,Google Inc.,Brand Asset Development,GI-Bro,39987099,56501,9706,46795,2022-07-29
3524,Google Inc.,Brand Publicity,Transmorphers,58232656,56440,49017,7423,2022-03-05
454,Pinterest Inc,E-Commerce,Transmorphers,64257315,56429,45475,10954,2022-03-12
441,Disney Studios,E-Commerce,GI-Bro,61058656,56422,3088,53334,2022-02-15
577,Pinterest Inc,E-Commerce,Merf,99242375,56404,37176,19228,2022-02-15
3367,Nintendo Technologies,Media Supported Asset,Transmorphers,87192129,56400,35097,21303,2022-01-11
4948,TikTok Inc,E-Commerce,Space Wars,57380386,56343,40670,15673,2022-01-12
1101,KYG Antler LLC,Media Supported Asset,GI-Bro,43058355,56338,8459,47879,2022-05-24
3902,The Martingale Agency,Influencer,Merf,26669057,56337,4452,51885,2022-09-20
2846,Meta Platforms,Brand Asset Development,GI-Bro,29864359,56302,40114,16188,2022-01-10
1747,TikTok Inc,Brand Publicity,GI-Bro,56840411,56297,6782,49515,2022-09-08
3377,Pinterest Inc,E-Commerce,GI-Bro,44322359,56293,30146,26147,2022-04-19
341,Google Inc.,E-Commerce,Space Wars,93796477,56203,37544,18659,2022-05-21
286,KYG Antler LLC,E-Commerce,Clay-Dough,22167491,56186,19802,36384,2022-07-17
103,Google Inc.,Brand Publicity,Merf,81180595,56183,18578,37605,2022-01-20
160,Pinterest Inc,Media Supported Asset,Clay-Dough,45315733,56177,46403,9774,2022-05-26
7,Nintendo Technologies,Brand Asset Development,GI-Bro,56888637,56169,5698,50471,2022-11-05
1833,Google Inc.,Brand Asset Development,Clay-Dough,71303441,56149,19095,37054,2022-03-19
3347,Pinterest Inc,Media Supported Asset,Merf,57455450,56132,35385,20747,2022-05-20
4913,TikTok Inc,Media Supported Asset,GI-Bro,36048008,56097,5959,50138,2022-11-11
2339,TikTok Inc,Media Supported Asset,Merf,10360792,56096,28295,27801,2022-03-31
3610,Meta Platforms,Brand Publicity,GI-Bro,94930946,56089,38176,17913,2022-04-04
3690,Google Inc.,Influencer,Transmorphers,30729837,56062,46622,9440,2022-01-15
1077,TikTok Inc,Brand Asset Development,Clay-Dough,49536333,56058,20916,35142,2022-04-26
84,Meta Platforms,Brand Asset Development,Space Wars,35612060,56001,8055,47946,2022-05-04
4702,The Martingale Agency,Influencer,Clay-Dough,33075944,55952,19954,35998,2022-02-22
1673,KYG Antler LLC,E-Commerce,Merf,67407375,55922,1019,54903,2022-10-26
3572,Disney Studios,E-Commerce,Space Wars,74316737,55919,16223,39696,2022-06-20
687,Nintendo Technologies,Brand Asset Development,GI-Bro,82355158,55901,26845,29056,2022-06-08
2492,Google Inc.,E-Commerce,Clay-Dough,94861971,55898,31930,23968,2022-04-24
3256,Google Inc.,Influencer,Merf,97380154,55892,13774,42118,2022-07-10
371,TikTok Inc,Brand Asset Development,Transmorphers,91486364,55882,22210,33672,2022-07-03
4048,TikTok Inc,Brand Asset Development,Transmorphers,83142734,55870,3256,52614,2022-10-07
133,Meta Platforms,Media Supported Asset,Transmorphers,44176993,55826,31461,24365,2022-05-29
4171,Google Inc.,Brand Publicity,GI-Bro,11103229,55800,5761,50039,2022-11-12
4339,KYG Antler LLC,Influencer,Clay-Dough,24735558,55799,12360,43439,2022-08-26
2211,Nintendo Technologies,E-Commerce,Merf,30477594,55783,21965,33818,2022-08-31
2151,TikTok Inc,Influencer,Transmorphers,42088874,55771,33979,21792,2022-02-12
3216,Pinterest Inc,E-Commerce,Transmorphers,98004553,55746,218,55528,2022-11-25
1896,Pinterest Inc,Brand Asset Development,Merf,95010555,55735,49595,6140,2022-04-27
149,Meta Platforms,Influencer,Clay-Dough,51482911,55726,5436,50290,2022-03-25
4542,The Martingale Agency,Media Supported Asset,Space Wars,26422279,55717,1026,54691,2022-11-25
1615,Pinterest Inc,Influencer,Clay-Dough,12167148,55705,40020,15685,2022-01-04
1338,Pinterest Inc,Media Supported Asset,Merf,59173241,55687,5076,50611,2022-11-09
2103,Meta Platforms,E-Commerce,Clay-Dough,78222571,55669,3583,52086,2022-11-04
3187,Pinterest Inc,Media Supported Asset,Space Wars,75370760,55606,47306,8300,2022-03-25
2655,Pinterest Inc,E-Commerce,GI-Bro,60120429,55545,2839,52706,2022-10-22
3071,Nintendo Technologies,Influencer,Space Wars,88427159,55542,23767,31775,2022-07-22
204,TikTok Inc,Media Supported Asset,GI-Bro,70831123,55536,5507,50029,2022-12-11
3067,Meta Platforms,Brand Asset Development,Merf,88648093,55530,48659,6871,2022-02-18
1792,TikTok Inc,Brand Publicity,Transmorphers,67629800,55508,4224,51284,2022-12-12
999,Google Inc.,Brand Publicity,Merf,13368385,55478,6056,49422,2022-06-01
4493,Disney Studios,Media Supported Asset,Clay-Dough,90476397,55459,9557,45902,2022-06-26
772,Google Inc.,E-Commerce,Space Wars,12784909,55436,25822,29614,2022-04-01
562,Pinterest Inc,Brand Asset Development,Clay-Dough,99104433,55429,14461,40968,2022-08-10
2855,Disney Studios,Media Supported Asset,Transmorphers,84834926,55416,7900,47516,2022-05-17
2141,Nintendo Technologies,Influencer,Merf,76666189,55401,33998,21403,2022-04-26
2823,Nintendo Technologies,Influencer,Transmorphers,76479995,55399,27986,27413,2022-02-04
3221,Meta Platforms,Media Supported Asset,Space Wars,96926336,55392,9465,45927,2022-06-03
421,Meta Platforms,E-Commerce,Clay-Dough,83731314,55385,34383,21002,2022-02-24
3879,Meta Platforms,E-Commerce,Clay-Dough,37419432,55377,3593,51784,2022-11-11
686,Pinterest Inc,Brand Asset Development,Transmorphers,64411856,55370,518,54852,2022-11-12
3791,Disney Studios,Influencer,Transmorphers,91543461,55362,45385,9977,2022-01-03
414,Google Inc.,Brand Asset Development,Transmorphers,26789348,55335,10173,45162,2022-07-19
2372,Pinterest Inc,E-Commerce,Clay-Dough,46031245,55320,43370,11950,2022-06-01
1537,Pinterest Inc,Brand Asset Development,GI-Bro,65088851,55308,40330,14978,2022-04-08
3926,KYG Antler LLC,Media Supported Asset,Space Wars,13366864,55298,28380,26918,2022-07-28
4680,Disney Studios,Media Supported Asset,Merf,82538907,55275,18052,37223,2022-07-28
1809,Nintendo Technologies,Brand Asset Development,Clay-Dough,72557766,55247,13789,41458,2022-08-07
1385,KYG Antler LLC,E-Commerce,Clay-Dough,79844364,55234,54178,1056,2022-02-28
2120,TikTok Inc,E-Commerce,Space Wars,87648863,55196,15286,39910,2022-01-23
243,KYG Antler LLC,Influencer,Space Wars,38937062,55167,44785,10382,2022-03-31
4017,Google Inc.,Media Supported Asset,Merf,81806432,55163,1367,53796,2022-11-22
2514,The Martingale Agency,Media Supported Asset,Merf,17969514,55116,29284,25832,2022-06-24
3097,Google Inc.,Brand Asset Development,Merf,45415427,55110,51188,3922,2022-03-07
3320,Meta Platforms,E-Commerce,Space Wars,47359008,55088,357,54731,2022-11-08
3421,Pinterest Inc,Brand Asset Development,GI-Bro,97030365,55070,36669,18401,2022-05-01
424,Disney Studios,Media Supported Asset,Clay-Dough,96909477,55070,3474,51596,2022-11-30
4836,Nintendo Technologies,Influencer,Space Wars,74111299,55054,22485,32569,2022-08-27
3050,Nintendo Technologies,E-Commerce,GI-Bro,40019283,55021,21227,33794,2022-04-18
4512,The Martingale Agency,Brand Publicity,GI-Bro,34573055,55019,823,54196,2022-12-16
2434,Disney Studios,Influencer,Transmorphers,55727409,55005,10342,44663,2022-05-14
1604,TikTok Inc,Media Supported Asset,Clay-Dough,98500480,54976,937,54039,2022-12-10
2545,TikTok Inc,Influencer,Transmorphers,42325292,54973,10431,44542,2022-07-02
2327,Disney Studios,Brand Asset Development,Space Wars,23327191,54973,45543,9430,2022-02-18
780,KYG Antler LLC,Brand Asset Development,GI-Bro,36975653,54965,8077,46888,2022-01-04
1153,Nintendo Technologies,Brand Asset Development,GI-Bro,79230497,54962,51153,3809,2022-05-12
2355,Nintendo Technologies,Media Supported Asset,Transmorphers,51541144,54909,20244,34665,2022-09-13
1036,Nintendo Technologies,E-Commerce,Clay-Dough,79217971,54888,46533,8355,2022-03-29
3533,KYG Antler LLC,Influencer,Transmorphers,31672825,54883,34599,20284,2022-04-29
276,Meta Platforms,Brand Asset Development,GI-Bro,53366353,54822,29838,24984,2022-04-22
1679,KYG Antler LLC,E-Commerce,Clay-Dough,85626697,54816,6036,48780,2022-01-11
3805,Disney Studios,E-Commerce,GI-Bro,50631216,54800,48803,5997,2022-04-25
3391,The Martingale Agency,E-Commerce,GI-Bro,90968109,54797,14777,40020,2022-01-13
3447,Nintendo Technologies,Influencer,Clay-Dough,44795995,54740,31765,22975,2022-06-06
1450,Meta Platforms,Media Supported Asset,Clay-Dough,95698868,54736,9494,45242,2022-04-08
4700,Pinterest Inc,E-Commerce,Clay-Dough,17614252,54710,3331,51379,2022-03-18
2581,Meta Platforms,Brand Publicity,Clay-Dough,47658758,54690,6906,47784,2022-07-21
2611,Pinterest Inc,Influencer,GI-Bro,54966326,54685,3872,50813,2022-12-11
4301,KYG Antler LLC,Influencer,Space Wars,70279158,54683,38361,16322,2022-04-25
4494,Nintendo Technologies,Media Supported Asset,Merf,92255495,54679,26484,28195,2022-05-16
2993,Disney Studios,E-Commerce,Merf,59287136,54661,5424,49237,2022-09-01
2029,KYG Antler LLC,Media Supported Asset,GI-Bro,48692303,54638,16015,38623,2022-09-08
4150,TikTok Inc,Brand Publicity,Merf,24378858,54578,336,54242,2022-10-04
1825,Nintendo Technologies,Brand Publicity,Clay-Dough,76228712,54553,16085,38468,2022-03-08
3935,Meta Platforms,Media Supported Asset,Transmorphers,80200407,54538,10396,44142,2022-06-05
404,Disney Studios,Influencer,Space Wars,21806323,54527,28020,26507,2022-09-26
2604,TikTok Inc,Media Supported Asset,Transmorphers,81785373,54493,47085,7408,2022-03-06
2274,Pinterest Inc,Influencer,Clay-Dough,81683030,54481,810,53671,2022-10-27
1501,The Martingale Agency,Media Supported Asset,GI-Bro,14839924,54473,22423,32050,2022-08-05
212,Nintendo Technologies,Brand Publicity,Transmorphers,34045851,54469,20697,33772,2022-01-13
1827,TikTok Inc,Brand Asset Development,Transmorphers,91065389,54435,44890,9545,2022-01-09
3504,Google Inc.,Influencer,Space Wars,95234282,54431,3787,50644,2022-10-24
4374,The Martingale Agency,Media Supported Asset,Space Wars,73896433,54416,1146,53270,2022-11-05
4588,Disney Studios,E-Commerce,Merf,26445199,54407,2250,52157,2022-11-27
1097,TikTok Inc,Influencer,GI-Bro,19766846,54407,2677,51730,2022-12-25
1523,TikTok Inc,Brand Asset Development,GI-Bro,27862065,54345,43879,10466,2022-06-21
3449,TikTok Inc,Brand Asset Development,Space Wars,43175448,54261,51817,2444,2022-05-24
4769,Disney Studios,Media Supported Asset,GI-Bro,66750057,54258,16229,38029,2022-07-19
2262,Pinterest Inc,Brand Publicity,Clay-Dough,34058420,54245,8603,45642,2022-03-19
96,Disney Studios,Brand Publicity,Space Wars,73146064,54243,1437,52806,2022-12-14
583,KYG Antler LLC,Influencer,Space Wars,22836271,54225,25501,28724,2022-08-29
1540,Google Inc.,E-Commerce,Merf,63817136,54190,44264,9926,2022-06-26
3576,Meta Platforms,Influencer,Clay-Dough,63015846,54156,2085,52071,2022-11-26
2312,TikTok Inc,Brand Asset Development,Merf,80752736,54142,21843,32299,2022-09-15
2247,Pinterest Inc,Brand Asset Development,GI-Bro,28052534,54137,26955,27182,2022-08-10
4423,Meta Platforms,E-Commerce,Transmorphers,61891314,54105,33669,20436,2022-06-27
2816,Pinterest Inc,E-Commerce,Space Wars,72790428,54079,32149,21930,2022-01-10
4928,TikTok Inc,Media Supported Asset,Space Wars,59454177,54071,10742,43329,2022-07-06
2935,KYG Antler LLC,Media Supported Asset,Transmorphers,93088761,54040,28145,25895,2022-07-02
1700,TikTok Inc,Brand Asset Development,Space Wars,10076593,54024,13768,40256,2022-08-20
836,The Martingale Agency,Brand Asset Development,Merf,84379372,54008,42364,11644,2022-03-03
2458,Pinterest Inc,Brand Publicity,Space Wars,46571948,53964,3277,50687,2022-12-08
4292,Disney Studios,Influencer,Transmorphers,51854803,53946,9029,44917,2022-05-18
2272,TikTok Inc,Media Supported Asset,GI-Bro,94943883,53933,1813,52120,2022-11-27
884,KYG Antler LLC,Influencer,Clay-Dough,49396438,53919,25112,28807,2022-01-24
3328,Pinterest Inc,Brand Publicity,Clay-Dough,98346973,53919,18812,35107,2022-09-11
3656,KYG Antler LLC,Media Supported Asset,Space Wars,98965944,53913,1550,52363,2022-09-26
897,Disney Studios,Influencer,GI-Bro,48425443,53910,31035,22875,2022-03-02
1656,Meta Platforms,Brand Asset Development,Clay-Dough,15190051,53899,43537,10362,2022-06-19
1297,KYG Antler LLC,Influencer,GI-Bro,63173235,53880,17491,36389,2022-03-12
1683,Nintendo Technologies,Media Supported Asset,GI-Bro,72620483,53867,1415,52452,2022-12-17
2008,Google Inc.,Brand Publicity,Space Wars,75543422,53852,2638,51214,2022-09-29
4426,Nintendo Technologies,Brand Asset Development,GI-Bro,41580146,53814,10364,43450,2022-08-28
2558,KYG Antler LLC,Influencer,Merf,43476743,53771,28120,25651,2022-04-21
2373,KYG Antler LLC,E-Commerce,Merf,50189022,53763,17995,35768,2022-09-13
3631,Meta Platforms,E-Commerce,Transmorphers,17256550,53760,48040,5720,2022-06-18
1802,KYG Antler LLC,Influencer,Merf,50116900,53758,13983,39775,2022-08-04
432,Disney Studios,Media Supported Asset,Transmorphers,57937291,53749,1232,52517,2022-10-26
3885,Google Inc.,Media Supported Asset,Merf,10115049,53709,4663,49046,2022-08-03
2776,Nintendo Technologies,Media Supported Asset,Merf,66049490,53695,6332,47363,2022-07-17
4418,KYG Antler LLC,Influencer,Space Wars,15394151,53690,51034,2656,2022-04-30
2718,The Martingale Agency,Brand Publicity,Transmorphers,24831491,53687,1071,52616,2022-11-05
2734,KYG Antler LLC,Influencer,GI-Bro,58209912,53684,2769,50915,2022-10-20
1952,TikTok Inc,Brand Asset Development,GI-Bro,77844805,53680,3099,50581,2022-12-24
3537,Google Inc.,Brand Asset Development,GI-Bro,36621667,53673,1895,51778,2022-11-11
4217,Nintendo Technologies,Brand Asset Development,Clay-Dough,74682029,53659,10968,42691,2022-09-11
3315,The Martingale Agency,Influencer,Space Wars,15993345,53646,3367,50279,2022-10-15
841,Disney Studios,Brand Publicity,Clay-Dough,84340278,53639,1221,52418,2022-11-02
1387,Nintendo Technologies,Brand Publicity,GI-Bro,62330114,53583,10750,42833,2022-04-01
729,Google Inc.,Brand Asset Development,GI-Bro,13609554,53547,617,52930,2022-12-21
2617,KYG Antler LLC,E-Commerce,Merf,54881979,53541,28465,25076,2022-02-10
1112,The Martingale Agency,Media Supported Asset,Clay-Dough,54178240,53498,5866,47632,2022-02-24
271,Meta Platforms,Media Supported Asset,Clay-Dough,45084377,53492,23581,29911,2022-06-14
302,KYG Antler LLC,E-Commerce,Space Wars,33332766,53469,24486,28983,2022-09-14
2049,The Martingale Agency,Brand Publicity,GI-Bro,55331323,53422,10622,42800,2022-02-21
3384,TikTok Inc,Media Supported Asset,Space Wars,77816116,53418,23979,29439,2022-02-22
2009,TikTok Inc,Media Supported Asset,Clay-Dough,71134498,53411,2059,51352,2022-09-19
3826,Disney Studios,Brand Publicity,Transmorphers,62153297,53402,50574,2828,2022-01-02
3370,Meta Platforms,Brand Asset Development,GI-Bro,44141854,53376,16982,36394,2022-07-23
4183,The Martingale Agency,Media Supported Asset,GI-Bro,44712134,53373,1724,51649,2022-10-30
1311,Pinterest Inc,Media Supported Asset,Clay-Dough,52229664,53319,593,52726,2022-05-07
1404,Meta Platforms,Media Supported Asset,Transmorphers,46803868,53266,21096,32170,2022-08-26
2859,The Martingale Agency,Brand Asset Development,Space Wars,95438962,53260,46523,6737,2022-05-09
2389,Disney Studios,Influencer,Clay-Dough,34656090,53231,1325,51906,2022-11-30
1300,Disney Studios,Media Supported Asset,Transmorphers,49346720,53157,147,53010,2022-11-08
2375,The Martingale Agency,Brand Asset Development,Merf,53571293,53130,10132,42998,2022-01-20
4717,Pinterest Inc,Media Supported Asset,GI-Bro,39668877,53124,373,52751,2022-10-22
1240,Google Inc.,Influencer,Space Wars,62928324,53118,18162,34956,2022-03-18
4687,Google Inc.,Brand Publicity,Clay-Dough,50739886,53101,9090,44011,2022-02-27
3919,KYG Antler LLC,Brand Asset Development,Clay-Dough,57079988,53101,2587,50514,2022-12-25
4861,Google Inc.,Brand Asset Development,Space Wars,55699519,53078,9728,43350,2022-04-14
3065,Meta Platforms,Brand Publicity,GI-Bro,32802551,53078,16289,36789,2022-07-17
3794,Google Inc.,Brand Publicity,Transmorphers,85346974,53066,7038,46028,2022-07-03
4919,The Martingale Agency,Influencer,Space Wars,79161965,52972,43048,9924,2022-03-31
2570,Meta Platforms,Brand Asset Development,Transmorphers,24693875,52972,3517,49455,2022-01-19
1922,Disney Studios,Media Supported Asset,Clay-Dough,31924399,52950,24852,28098,2022-03-04
1907,The Martingale Agency,Media Supported Asset,Space Wars,56455202,52900,14470,38430,2022-08-19
1183,KYG Antler LLC,Brand Publicity,Space Wars,59866203,52891,48956,3935,2022-06-10
1659,Meta Platforms,E-Commerce,Space Wars,85378220,52883,2266,50617,2022-10-26
3771,KYG Antler LLC,E-Commerce,Merf,41967090,52865,1072,51793,2022-04-15
136,KYG Antler LLC,Influencer,Clay-Dough,28066730,52864,17877,34987,2022-06-21
3022,The Martingale Agency,Brand Asset Development,GI-Bro,68675217,52837,6900,45937,2022-01-16
4572,The Martingale Agency,Brand Publicity,Clay-Dough,83620345,52781,22822,29959,2022-05-10
4611,KYG Antler LLC,Brand Publicity,Space Wars,90232662,52739,10013,42726,2022-04-07
1550,The Martingale Agency,Brand Asset Development,Clay-Dough,80645971,52724,1717,51007,2022-11-10
4873,Google Inc.,Influencer,Clay-Dough,55893201,52708,33578,19130,2022-03-06
2561,Nintendo Technologies,Brand Asset Development,Clay-Dough,11299734,52667,2891,49776,2022-02-17
2517,Pinterest Inc,Media Supported Asset,Space Wars,73496495,52611,1309,51302,2022-12-07
4539,Meta Platforms,E-Commerce,Transmorphers,34063449,52610,6994,45616,2022-08-10
2295,Meta Platforms,E-Commerce,Transmorphers,58551329,52595,48123,4472,2022-06-18
689,Disney Studios,Brand Publicity,Space Wars,13674163,52562,30278,22284,2022-04-27
1909,Pinterest Inc,Brand Asset Development,GI-Bro,73046239,52513,45691,6822,2022-02-18
2356,TikTok Inc,Brand Publicity,Merf,58468780,52453,46604,5849,2022-04-09
4814,Disney Studios,E-Commerce,Merf,35412652,52398,5310,47088,2022-02-20
2795,Google Inc.,E-Commerce,Space Wars,30371370,52341,43671,8670,2022-06-19
4024,TikTok Inc,Brand Publicity,Space Wars,68399582,52335,39412,12923,2022-04-28
1585,TikTok Inc,Influencer,Clay-Dough,97416716,52291,7119,45172,2022-09-02
1864,Pinterest Inc,Influencer,Merf,90549186,52290,5428,46862,2022-07-30
3218,Google Inc.,Brand Publicity,Transmorphers,90941742,52288,439,51849,2022-10-21
2892,TikTok Inc,E-Commerce,GI-Bro,38593985,52274,10788,41486,2022-03-03
1579,Nintendo Technologies,Brand Publicity,Clay-Dough,76865434,52267,9198,43069,2022-05-27
896,Pinterest Inc,Brand Publicity,GI-Bro,59001406,52212,19427,32785,2022-08-26
3176,Nintendo Technologies,Brand Asset Development,Merf,18694588,52174,2127,50047,2022-12-08
150,TikTok Inc,Brand Publicity,Merf,62827756,52161,42743,9418,2022-05-31
3905,The Martingale Agency,Media Supported Asset,GI-Bro,31477084,52145,1396,50749,2022-11-01
2601,Google Inc.,Influencer,GI-Bro,82603908,52145,1350,50795,2022-10-15
3671,Disney Studios,Brand Publicity,GI-Bro,27136731,52142,7947,44195,2022-03-04
2065,Google Inc.,Brand Publicity,Transmorphers,19267460,52126,1075,51051,2022-10-08
3868,Meta Platforms,Brand Publicity,Merf,51607435,52124,19500,32624,2022-09-21
4515,Meta Platforms,E-Commerce,Transmorphers,23934654,52120,12069,40051,2022-02-27
1816,TikTok Inc,Brand Asset Development,GI-Bro,51582757,52077,9867,42210,2022-06-03
4436,Nintendo Technologies,E-Commerce,GI-Bro,48099867,52072,14542,37530,2022-03-26
4523,Google Inc.,Media Supported Asset,Space Wars,55372560,52066,50114,1952,2022-03-14
2337,Disney Studios,Brand Asset Development,GI-Bro,12629157,52046,3181,48865,2022-07-30
4768,KYG Antler LLC,Influencer,GI-Bro,85173795,52043,12545,39498,2022-05-22
3714,Google Inc.,Brand Publicity,Merf,35631240,52033,40548,11485,2022-02-26
1905,Disney Studios,E-Commerce,Clay-Dough,77512883,52030,185,51845,2022-11-24
291,Nintendo Technologies,Influencer,Merf,75233045,52017,30588,21429,2022-06-20
4944,Disney Studios,Brand Asset Development,Space Wars,58243296,51991,51880,111,2022-01-08
1440,Meta Platforms,E-Commerce,Space Wars,38749585,51974,23449,28525,2022-08-22
3528,Nintendo Technologies,Brand Asset Development,Clay-Dough,34489114,51958,16,51942,2022-12-03
4218,Pinterest Inc,Media Supported Asset,Space Wars,18550661,51952,19365,32587,2022-08-07
350,TikTok Inc,Brand Asset Development,Transmorphers,25837817,51936,7187,44749,2022-09-04
1308,TikTok Inc,Brand Publicity,Space Wars,60491106,51923,692,51231,2022-12-02
557,Google Inc.,E-Commerce,Transmorphers,42312415,51905,1328,50577,2022-10-11
2338,Nintendo Technologies,Influencer,Merf,96086760,51892,5353,46539,2022-08-04
730,Google Inc.,E-Commerce,Transmorphers,94232362,51888,2268,49620,2022-01-20
141,Google Inc.,Brand Publicity,Space Wars,46962902,51881,10550,41331,2022-04-22
3730,The Martingale Agency,E-Commerce,Transmorphers,48520391,51868,1899,49969,2022-06-19
2423,The Martingale Agency,E-Commerce,Transmorphers,57124352,51743,16861,34882,2022-05-02
4827,Meta Platforms,Brand Publicity,Clay-Dough,14017461,51729,1492,50237,2022-10-22
3091,The Martingale Agency,Brand Asset Development,Clay-Dough,91151121,51723,12648,39075,2022-01-20
1090,Meta Platforms,Influencer,Space Wars,81230640,51718,1215,50503,2022-12-06
275,KYG Antler LLC,Influencer,Space Wars,19572189,51708,1079,50629,2022-10-20
2300,Google Inc.,Brand Asset Development,Space Wars,10127016,51705,42592,9113,2022-04-17
383,Pinterest Inc,Brand Asset Development,Transmorphers,79280253,51700,942,50758,2022-10-05
554,Pinterest Inc,Media Supported Asset,Transmorphers,85257290,51684,30062,21622,2022-01-14
1003,TikTok Inc,Influencer,Clay-Dough,31895001,51662,17590,34072,2022-03-26
3962,The Martingale Agency,Brand Asset Development,Clay-Dough,17031528,51637,13390,38247,2022-04-01
3726,Pinterest Inc,Media Supported Asset,Transmorphers,52044140,51628,6407,45221,2022-06-26
4071,Google Inc.,Influencer,Transmorphers,70330995,51625,468,51157,2022-10-19
1122,Google Inc.,Brand Publicity,GI-Bro,62295147,51587,41114,10473,2022-04-06
2905,TikTok Inc,Influencer,Merf,11544669,51542,48451,3091,2022-02-09
1880,The Martingale Agency,Brand Asset Development,Transmorphers,25284978,51511,25570,25941,2022-05-05
139,Meta Platforms,Brand Asset Development,Merf,37319919,51506,3391,48115,2022-07-28
892,Nintendo Technologies,Influencer,Clay-Dough,50619923,51487,427,51060,2022-12-17
3488,Disney Studios,Influencer,Transmorphers,33933522,51463,23391,28072,2022-06-19
1687,Pinterest Inc,Influencer,GI-Bro,72593576,51462,44141,7321,2022-02-08
4054,The Martingale Agency,Media Supported Asset,Merf,99584630,51377,1188,50189,2022-10-12
94,Google Inc.,Brand Publicity,Space Wars,81736199,51337,18786,32551,2022-08-21
4173,Pinterest Inc,Influencer,GI-Bro,82470656,51331,108,51223,2022-11-01
1091,KYG Antler LLC,Media Supported Asset,GI-Bro,64906659,51330,46394,4936,2022-04-08
2045,Nintendo Technologies,Brand Asset Development,Merf,73163793,51284,33452,17832,2022-04-12
3317,Pinterest Inc,Influencer,GI-Bro,41340219,51241,3987,47254,2022-08-21
3609,TikTok Inc,Media Supported Asset,Transmorphers,29415062,51205,919,50286,2022-11-22
3709,Pinterest Inc,Brand Asset Development,Merf,75995353,51183,948,50235,2022-10-28
4408,Nintendo Technologies,Influencer,Clay-Dough,19074707,51179,50915,264,2022-04-08
373,The Martingale Agency,Media Supported Asset,GI-Bro,47380551,51172,27453,23719,2022-05-26
1327,TikTok Inc,Brand Publicity,Clay-Dough,21669689,51150,13352,37798,2022-03-24
1815,The Martingale Agency,Media Supported Asset,Merf,29292047,51120,18172,32948,2022-01-26
4978,KYG Antler LLC,E-Commerce,Space Wars,12265127,51033,212,50821,2022-11-27
2403,TikTok Inc,Brand Asset Development,Transmorphers,14189022,51029,12249,38780,2022-07-09
3084,Pinterest Inc,Brand Publicity,Space Wars,51399083,51021,761,50260,2022-12-01
2283,The Martingale Agency,Influencer,Merf,56098856,51008,497,50511,2022-12-07
3802,TikTok Inc,Media Supported Asset,GI-Bro,75864193,51003,874,50129,2022-10-08
2946,Disney Studios,Media Supported Asset,Space Wars,45748001,50992,16562,34430,2022-09-09
1355,TikTok Inc,Brand Asset Development,Merf,20540120,50986,21483,29503,2022-07-03
2660,KYG Antler LLC,E-Commerce,Merf,54482665,50965,1653,49312,2022-09-23
4669,TikTok Inc,Brand Publicity,Space Wars,92992199,50962,45575,5387,2022-04-08
4421,Disney Studios,Influencer,Merf,50567260,50956,4563,46393,2022-07-27
1997,TikTok Inc,Brand Publicity,GI-Bro,72809683,50938,272,50666,2022-10-24
2704,Meta Platforms,Brand Publicity,GI-Bro,68800499,50932,18593,32339,2022-06-12
4946,Nintendo Technologies,Brand Publicity,Space Wars,59809985,50887,7365,43522,2022-06-29
1107,Pinterest Inc,Media Supported Asset,GI-Bro,86784531,50877,17478,33399,2022-02-20
1681,TikTok Inc,Influencer,Space Wars,22862390,50852,27412,23440,2022-04-17
2792,KYG Antler LLC,Media Supported Asset,Clay-Dough,68222436,50824,4036,46788,2022-08-24
3869,Pinterest Inc,Brand Publicity,Merf,91695433,50808,5473,45335,2022-08-21
720,The Martingale Agency,Influencer,Transmorphers,46702595,50799,404,50395,2022-12-07
2006,Nintendo Technologies,Brand Asset Development,GI-Bro,52600169,50769,41292,9477,2022-02-20
1651,TikTok Inc,E-Commerce,GI-Bro,19288054,50768,2177,48591,2022-07-27
1382,Meta Platforms,Brand Asset Development,GI-Bro,64734026,50765,480,50285,2022-11-19
3303,KYG Antler LLC,E-Commerce,GI-Bro,93930994,50681,405,50276,2022-12-23
2509,TikTok Inc,Brand Asset Development,Merf,59521569,50672,30544,20128,2022-01-06
2548,The Martingale Agency,Influencer,Clay-Dough,27308383,50665,18862,31803,2022-03-23
2850,Google Inc.,Influencer,Transmorphers,23846017,50655,23273,27382,2022-08-24
3428,Nintendo Technologies,Media Supported Asset,Clay-Dough,40392248,50619,201,50418,2022-10-30
633,Pinterest Inc,Influencer,Transmorphers,77987689,50617,49125,1492,2022-02-10
2924,The Martingale Agency,E-Commerce,Space Wars,80103548,50609,552,50057,2022-11-01
1368,Nintendo Technologies,Brand Asset Development,Clay-Dough,60732474,50596,576,50020,2022-11-22
1098,Nintendo Technologies,Brand Asset Development,GI-Bro,11437250,50594,35258,15336,2022-05-24
4194,Nintendo Technologies,E-Commerce,GI-Bro,17989887,50563,41003,9560,2022-03-18
4950,Disney Studios,E-Commerce,Clay-Dough,21099586,50531,21,50510,2022-11-01
2609,TikTok Inc,Brand Asset Development,Transmorphers,12482923,50504,8119,42385,2022-05-16
2388,Pinterest Inc,Brand Asset Development,Transmorphers,10032395,50503,246,50257,2022-10-26
3194,Disney Studios,Brand Publicity,Merf,31118817,50498,45860,4638,2022-04-30
455,TikTok Inc,Brand Publicity,Merf,47137793,50487,163,50324,2022-11-01
2918,Disney Studios,Brand Publicity,GI-Bro,80481419,50474,1944,48530,2022-06-22
4643,Pinterest Inc,Influencer,Space Wars,82687617,50472,10922,39550,2022-09-04
3073,Pinterest Inc,Media Supported Asset,Transmorphers,11813531,50467,16350,34117,2022-08-08
340,Pinterest Inc,Media Supported Asset,Merf,72164304,50460,33365,17095,2022-05-06
2237,Meta Platforms,Brand Publicity,GI-Bro,25799968,50446,25595,24851,2022-05-08
1823,Nintendo Technologies,Influencer,Merf,76255308,50426,7268,43158,2022-08-11
3665,KYG Antler LLC,Media Supported Asset,Space Wars,83433783,50399,5197,45202,2022-07-08
1014,Pinterest Inc,E-Commerce,Clay-Dough,79478384,50386,14803,35583,2022-06-05
833,Disney Studios,Brand Asset Development,Merf,28537727,50381,7082,43299,2022-07-10
146,Google Inc.,Brand Publicity,GI-Bro,80287820,50360,4756,45604,2022-02-10
564,Meta Platforms,Media Supported Asset,Merf,23663743,50306,12036,38270,2022-09-02
2130,Meta Platforms,Influencer,Merf,47801630,50305,22,50283,2022-12-05
1418,Disney Studios,Media Supported Asset,Clay-Dough,90267166,50288,239,50049,2022-12-20
3624,Disney Studios,E-Commerce,Space Wars,28314716,50243,7100,43143,2022-07-11
3639,Disney Studios,Influencer,Transmorphers,39161994,50225,46602,3623,2022-04-30
698,Meta Platforms,Media Supported Asset,Clay-Dough,46698275,50204,43,50161,2022-11-09
453,Pinterest Inc,Brand Asset Development,Clay-Dough,90571912,50204,22506,27698,2022-09-02
3378,TikTok Inc,Media Supported Asset,Clay-Dough,81905836,50120,16944,33176,2022-08-23
549,The Martingale Agency,Brand Asset Development,Transmorphers,65929098,50106,34332,15774,2022-06-29
4470,The Martingale Agency,Brand Asset Development,Clay-Dough,67830524,50106,5133,44973,2022-02-26
3644,TikTok Inc,Media Supported Asset,Merf,90498908,50104,22648,27456,2022-06-17
4887,Nintendo Technologies,Brand Asset Development,GI-Bro,94336294,50061,28766,21295,2022-02-18
2281,KYG Antler LLC,Brand Asset Development,GI-Bro,54194311,50040,14137,35903,2022-09-19
67,KYG Antler LLC,Brand Publicity,Merf,10023386,50005,16700,33305,2022-05-15
1698,Disney Studios,Brand Asset Development,Merf,98341675,49984,16053,33931,2022-07-22
3190,KYG Antler LLC,Influencer,Merf,11495304,49935,16557,33378,2022-07-28
2796,Pinterest Inc,Brand Asset Development,Merf,99556939,49907,11689,38218,2022-05-17
3238,Meta Platforms,E-Commerce,Space Wars,89029305,49903,31468,18435,2022-01-14
4511,KYG Antler LLC,E-Commerce,Space Wars,26169048,49878,9597,40281,2022-02-14
942,TikTok Inc,Brand Publicity,Transmorphers,11761212,49871,35376,14495,2022-05-11
4794,Disney Studios,Brand Publicity,GI-Bro,42837210,49829,32912,16917,2022-04-05
4672,KYG Antler LLC,E-Commerce,Transmorphers,74221517,49798,43128,6670,2022-03-09
575,Nintendo Technologies,E-Commerce,Space Wars,72880613,49761,9180,40581,2022-05-02
3923,Nintendo Technologies,E-Commerce,Space Wars,77678740,49759,6935,42824,2022-08-21
3399,Nintendo Technologies,Influencer,Transmorphers,88603416,49748,34694,15054,2022-05-21
2893,Meta Platforms,E-Commerce,Clay-Dough,23752663,49735,11310,38425,2022-08-10
4464,KYG Antler LLC,Influencer,Space Wars,85170826,49729,3505,46224,2022-01-25
1583,TikTok Inc,Brand Publicity,Space Wars,93243843,49655,12910,36745,2022-08-13
4258,Pinterest Inc,E-Commerce,Merf,28657524,49638,21269,28369,2022-01-14
3758,Meta Platforms,Brand Asset Development,Merf,84472725,49628,9897,39731,2022-09-14
318,Google Inc.,Brand Asset Development,Transmorphers,36103573,49594,36590,13004,2022-03-06
4320,Disney Studios,Media Supported Asset,Transmorphers,16856136,49551,12399,37152,2022-07-26
1532,The Martingale Agency,Brand Asset Development,Transmorphers,62128992,49538,17935,31603,2022-07-21
3053,Nintendo Technologies,Brand Publicity,Merf,82342602,49532,46347,3185,2022-06-08
3170,TikTok Inc,Media Supported Asset,Space Wars,79766754,49531,15121,34410,2022-07-25
3008,The Martingale Agency,Media Supported Asset,Merf,28135694,49529,47347,2182,2022-05-18
182,Disney Studios,Media Supported Asset,Merf,93489122,49507,18338,31169,2022-07-19
245,Meta Platforms,Brand Asset Development,Merf,95115020,49474,40433,9041,2022-05-16
3089,KYG Antler LLC,Influencer,Transmorphers,27620157,49431,30959,18472,2022-06-12
1066,Google Inc.,Brand Publicity,GI-Bro,74969336,49398,5875,43523,2022-02-20
3270,Pinterest Inc,Influencer,GI-Bro,83262911,49352,6555,42797,2022-08-18
1333,KYG Antler LLC,E-Commerce,Space Wars,16194529,49320,41069,8251,2022-02-24
4375,TikTok Inc,Brand Asset Development,Transmorphers,87136920,49293,2588,46705,2022-02-03
1119,KYG Antler LLC,E-Commerce,Transmorphers,96170998,49270,13414,35856,2022-01-20
4389,Nintendo Technologies,E-Commerce,Space Wars,20558310,49247,42177,7070,2022-01-30
1081,Nintendo Technologies,Influencer,GI-Bro,64332107,49233,29999,19234,2022-05-14
4032,Disney Studios,Influencer,Transmorphers,33434613,49214,45766,3448,2022-03-05
3733,TikTok Inc,Brand Publicity,GI-Bro,89499042,49203,27859,21344,2022-04-18
3666,Google Inc.,Brand Asset Development,Transmorphers,10896304,49191,7694,41497,2022-08-23
3942,TikTok Inc,E-Commerce,Transmorphers,29056026,49167,44998,4169,2022-04-29
3430,Google Inc.,Brand Asset Development,GI-Bro,70592337,49162,30005,19157,2022-06-06
1599,Google Inc.,Brand Asset Development,Space Wars,92374287,49104,20637,28467,2022-05-07
2614,Nintendo Technologies,Brand Asset Development,Merf,32973422,49079,868,48211,2022-05-07
1754,The Martingale Agency,Influencer,GI-Bro,62441738,49062,44212,4850,2022-05-01
3993,Google Inc.,Media Supported Asset,GI-Bro,66562792,49040,10607,38433,2022-07-08
400,KYG Antler LLC,Brand Asset Development,GI-Bro,36387412,48882,14626,34256,2022-08-19
2267,Disney Studios,E-Commerce,Transmorphers,92002923,48881,23571,25310,2022-08-31
405,Meta Platforms,Media Supported Asset,Transmorphers,81266833,48862,18950,29912,2022-07-27
1932,The Martingale Agency,Brand Asset Development,Merf,21925039,48762,9810,38952,2022-01-18
4795,Nintendo Technologies,E-Commerce,Clay-Dough,87578184,48712,20561,28151,2022-04-04
327,Nintendo Technologies,E-Commerce,Clay-Dough,93735675,48687,39668,9019,2022-02-08
507,Google Inc.,Brand Publicity,Merf,18318164,48666,21006,27660,2022-03-06
4942,The Martingale Agency,Media Supported Asset,GI-Bro,30276879,48657,36393,12264,2022-01-17
11,Google Inc.,Influencer,Transmorphers,22357237,48599,43496,5103,2022-04-12
1196,The Martingale Agency,Influencer,GI-Bro,12525678,48573,18340,30233,2022-05-18
748,TikTok Inc,E-Commerce,Clay-Dough,52972723,48546,7600,40946,2022-01-22
1536,Disney Studios,Brand Publicity,Transmorphers,90405644,48541,19467,29074,2022-08-31
106,TikTok Inc,Media Supported Asset,Transmorphers,94018735,48530,13661,34869,2022-08-15
4280,TikTok Inc,Influencer,Space Wars,14734690,48462,18286,30176,2022-01-24
2702,Nintendo Technologies,E-Commerce,Clay-Dough,78541939,48441,17555,30886,2022-07-03
1936,Nintendo Technologies,Brand Asset Development,GI-Bro,59737704,48417,12805,35612,2022-01-21
1028,TikTok Inc,Brand Publicity,Space Wars,68264276,48304,16283,32021,2022-01-16
1805,Nintendo Technologies,Media Supported Asset,Space Wars,76304445,48270,36108,12162,2022-01-12
2071,TikTok Inc,Influencer,GI-Bro,25425253,48229,8580,39649,2022-02-13
4406,Pinterest Inc,Brand Asset Development,GI-Bro,19913154,48225,28119,20106,2022-05-17
4901,KYG Antler LLC,Brand Publicity,Merf,93521653,48116,2568,45548,2022-09-15
2149,TikTok Inc,Media Supported Asset,Transmorphers,34344856,48103,36533,11570,2022-01-13
361,Disney Studios,Brand Asset Development,Merf,96235319,48077,31020,17057,2022-02-16
771,Google Inc.,Brand Asset Development,Transmorphers,27357300,48060,12069,35991,2022-09-17
144,The Martingale Agency,E-Commerce,Transmorphers,25592502,48059,11043,37016,2022-02-25
1670,KYG Antler LLC,Brand Publicity,Merf,44133619,48029,44725,3304,2022-05-21
615,Google Inc.,Media Supported Asset,Space Wars,67787628,48020,30398,17622,2022-01-30
864,Nintendo Technologies,E-Commerce,Clay-Dough,48614706,48006,47739,267,2022-03-09
1221,The Martingale Agency,E-Commerce,GI-Bro,68215389,47982,1961,46021,2022-04-29
4586,Google Inc.,Influencer,Space Wars,25182405,47938,141,47797,2022-04-12
664,Meta Platforms,E-Commerce,Clay-Dough,18480402,47935,24817,23118,2022-02-01
2457,Pinterest Inc,Brand Asset Development,Clay-Dough,29074013,47868,38571,9297,2022-05-02
4451,Disney Studios,Brand Publicity,Merf,96955254,47846,8418,39428,2022-08-10
4909,KYG Antler LLC,E-Commerce,Clay-Dough,45214921,47797,27571,20226,2022-05-19
3534,KYG Antler LLC,Influencer,GI-Bro,10183208,47796,2797,44999,2022-02-18
3111,The Martingale Agency,E-Commerce,Transmorphers,15155807,47793,8463,39330,2022-08-31
1609,Disney Studios,Brand Asset Development,Clay-Dough,79457935,47752,22288,25464,2022-09-12
2100,The Martingale Agency,E-Commerce,GI-Bro,37567988,47730,11094,36636,2022-07-05
1402,KYG Antler LLC,Media Supported Asset,Transmorphers,49478566,47723,47414,309,2022-01-19
461,KYG Antler LLC,Influencer,GI-Bro,32538760,47723,35225,12498,2022-01-11
733,Nintendo Technologies,Brand Asset Development,Clay-Dough,15122564,47674,42035,5639,2022-04-05
3907,Pinterest Inc,E-Commerce,Space Wars,64613111,47664,12557,35107,2022-09-15
293,Pinterest Inc,Brand Asset Development,Merf,29237714,47641,43944,3697,2022-05-22
1516,Disney Studios,Brand Asset Development,GI-Bro,40237604,47628,14360,33268,2022-08-08
3815,KYG Antler LLC,Influencer,Transmorphers,70769101,47580,14256,33324,2022-04-04
1494,Nintendo Technologies,Brand Publicity,GI-Bro,47781579,47568,41135,6433,2022-06-05
2738,Meta Platforms,Influencer,Space Wars,79056211,47548,15412,32136,2022-07-11
2716,Disney Studios,Media Supported Asset,Transmorphers,59359380,47496,2416,45080,2022-02-22
1948,Nintendo Technologies,Brand Asset Development,Merf,71197189,47476,5802,41674,2022-07-18
3522,TikTok Inc,E-Commerce,Merf,54265048,47452,32383,15069,2022-02-25
3841,Meta Platforms,Brand Asset Development,Transmorphers,28749634,47447,37056,10391,2022-02-25
1741,Disney Studios,Brand Asset Development,Merf,22424132,47441,33260,14181,2022-06-12
3095,Disney Studios,Media Supported Asset,GI-Bro,13871164,47439,25665,21774,2022-06-20
2167,TikTok Inc,Media Supported Asset,Clay-Dough,30480043,47426,38609,8817,2022-05-15
537,KYG Antler LLC,Brand Asset Development,Merf,23610417,47417,2285,45132,2022-09-21
1818,Nintendo Technologies,Brand Publicity,Transmorphers,27194910,47377,4759,42618,2022-01-29
4507,Disney Studios,Influencer,GI-Bro,19566400,47359,15983,31376,2022-02-04
3017,KYG Antler LLC,Brand Asset Development,Clay-Dough,51508727,47269,24123,23146,2022-04-26
1644,Nintendo Technologies,Influencer,Clay-Dough,17678748,47239,36264,10975,2022-06-19
1928,Meta Platforms,E-Commerce,GI-Bro,93023077,47220,18833,28387,2022-06-07
3462,Nintendo Technologies,Media Supported Asset,Clay-Dough,47991964,47180,34373,12807,2022-04-11
2485,KYG Antler LLC,Media Supported Asset,Transmorphers,98381489,47115,22608,24507,2022-06-29
2489,KYG Antler LLC,Influencer,GI-Bro,35325796,47043,16449,30594,2022-05-26
1372,TikTok Inc,Brand Publicity,Merf,25212121,46979,8857,38122,2022-07-09
49,KYG Antler LLC,Influencer,Space Wars,50188172,46975,7250,39725,2022-02-27
3285,Disney Studios,Brand Publicity,Transmorphers,29032777,46930,34093,12837,2022-02-09
2231,Disney Studios,Brand Publicity,GI-Bro,62618208,46915,36435,10480,2022-06-19
3939,Google Inc.,Influencer,GI-Bro,42808607,46833,35891,10942,2022-04-14
4241,Meta Platforms,Media Supported Asset,Clay-Dough,60655126,46830,2318,44512,2022-09-01
3356,Nintendo Technologies,Media Supported Asset,GI-Bro,34491944,46824,14467,32357,2022-06-15
682,TikTok Inc,Brand Asset Development,GI-Bro,85493876,46770,36360,10410,2022-01-23
3540,The Martingale Agency,E-Commerce,Space Wars,94105349,46764,26233,20531,2022-04-23
1702,Disney Studios,Brand Publicity,Space Wars,48933179,46718,11611,35107,2022-01-29
1127,Disney Studios,Influencer,Merf,22395833,46710,5586,41124,2022-09-12
3739,The Martingale Agency,E-Commerce,Transmorphers,35207113,46705,42737,3968,2022-06-29
201,TikTok Inc,Brand Asset Development,Merf,61355583,46671,13899,32772,2022-07-18
1237,The Martingale Agency,Brand Asset Development,Merf,17432827,46656,2979,43677,2022-08-17
4748,Meta Platforms,Brand Publicity,Merf,97802895,46651,39274,7377,2022-04-16
1807,Disney Studios,Influencer,Clay-Dough,15154863,46635,16125,30510,2022-09-08
819,Meta Platforms,Media Supported Asset,Transmorphers,42073624,46633,7230,39403,2022-06-16
646,The Martingale Agency,Brand Asset Development,Clay-Dough,12065642,46624,37973,8651,2022-03-16
932,Disney Studios,Brand Asset Development,GI-Bro,27509020,46519,16349,30170,2022-06-24
1441,TikTok Inc,Brand Asset Development,GI-Bro,21139647,46433,40523,5910,2022-03-27
1165,Nintendo Technologies,Brand Asset Development,Space Wars,27546341,46404,25536,20868,2022-02-08
4327,The Martingale Agency,Influencer,GI-Bro,65245460,46397,17421,28976,2022-07-06
3030,Pinterest Inc,Brand Asset Development,Space Wars,22226934,46330,14182,32148,2022-07-01
4267,Pinterest Inc,Brand Asset Development,Clay-Dough,93219739,46270,18527,27743,2022-07-15
822,KYG Antler LLC,E-Commerce,Transmorphers,72127359,46227,11770,34457,2022-07-01
1110,Pinterest Inc,E-Commerce,Transmorphers,83956147,46197,8353,37844,2022-03-05
2165,Meta Platforms,Media Supported Asset,Clay-Dough,61089763,46172,7961,38211,2022-05-04
3697,TikTok Inc,Media Supported Asset,Merf,16553685,46143,30620,15523,2022-06-22
3880,Google Inc.,Brand Publicity,Merf,92879477,46112,675,45437,2022-03-01
2844,Google Inc.,Influencer,GI-Bro,23663961,46084,24453,21631,2022-01-02
3809,The Martingale Agency,Brand Publicity,Space Wars,40951568,46084,2922,43162,2022-09-24
4563,TikTok Inc,E-Commerce,Space Wars,82071658,46033,38528,7505,2022-01-29
2566,Nintendo Technologies,Brand Publicity,Space Wars,31594287,46025,19345,26680,2022-09-30
4282,Google Inc.,Influencer,Merf,76346542,46016,20600,25416,2022-09-24
3550,Nintendo Technologies,E-Commerce,Merf,54774510,46013,40017,5996,2022-01-12
1740,The Martingale Agency,Brand Publicity,Space Wars,22307383,45975,38904,7071,2022-03-02
2562,Nintendo Technologies,Influencer,Transmorphers,51612359,45945,39247,6698,2022-01-23
2161,Disney Studios,Brand Asset Development,GI-Bro,79344698,45942,18644,27298,2022-09-07
2108,Disney Studios,Brand Publicity,GI-Bro,76604438,45896,5630,40266,2022-09-09
3672,Pinterest Inc,Media Supported Asset,GI-Bro,87002341,45793,17635,28158,2022-08-29
961,Nintendo Technologies,Influencer,Transmorphers,77067952,45774,31910,13864,2022-05-18
1542,TikTok Inc,Brand Publicity,Merf,34207315,45747,15251,30496,2022-05-02
472,The Martingale Agency,E-Commerce,Transmorphers,35342313,45684,17728,27956,2022-06-24
4821,Meta Platforms,Brand Asset Development,Merf,75650532,45681,9423,36258,2022-08-06
3469,Disney Studios,Brand Publicity,Space Wars,55551193,45671,20677,24994,2022-02-10
4432,KYG Antler LLC,Brand Asset Development,GI-Bro,33231139,45641,22957,22684,2022-03-11
787,The Martingale Agency,Media Supported Asset,Space Wars,76856871,45639,35773,9866,2022-02-27
487,Meta Platforms,Brand Asset Development,Clay-Dough,33351990,45530,8041,37489,2022-04-15
75,The Martingale Agency,E-Commerce,GI-Bro,99632425,45506,8870,36636,2022-08-17
1200,TikTok Inc,E-Commerce,Transmorphers,64407736,45482,18223,27259,2022-02-06
1903,Nintendo Technologies,Brand Asset Development,Space Wars,20574665,45467,41927,3540,2022-01-19
3003,Pinterest Inc,E-Commerce,Space Wars,62655559,45443,12209,33234,2022-09-27
1181,Meta Platforms,Media Supported Asset,Merf,67877004,45431,12219,33212,2022-09-16
284,Pinterest Inc,Brand Publicity,Space Wars,97834803,45419,648,44771,2022-08-15
3921,TikTok Inc,Brand Publicity,GI-Bro,82150684,45395,42789,2606,2022-01-18
4404,KYG Antler LLC,Influencer,Clay-Dough,36164555,45338,17286,28052,2022-08-01
3597,Nintendo Technologies,Media Supported Asset,Space Wars,44908102,45299,11413,33886,2022-05-31
1623,TikTok Inc,Brand Asset Development,Space Wars,94561177,45256,18932,26324,2022-07-08
1971,Nintendo Technologies,Media Supported Asset,Space Wars,40419626,45247,39038,6209,2022-04-18
3722,TikTok Inc,Media Supported Asset,Merf,54981451,45232,309,44923,2022-09-29
654,TikTok Inc,Media Supported Asset,Space Wars,57799311,45224,4140,41084,2022-02-21
3049,TikTok Inc,Brand Asset Development,Clay-Dough,99344308,45169,27408,17761,2022-04-16
3451,Pinterest Inc,Influencer,Space Wars,45245791,45163,29257,15906,2022-02-22
2067,The Martingale Agency,E-Commerce,Merf,76078716,45143,3433,41710,2022-04-04
154,TikTok Inc,Influencer,Clay-Dough,30340662,45096,23797,21299,2022-04-09
4849,Pinterest Inc,Media Supported Asset,GI-Bro,41417924,45088,10023,35065,2022-02-22
4430,Disney Studios,E-Commerce,Clay-Dough,20106996,45059,16670,28389,2022-07-31
3203,Pinterest Inc,Media Supported Asset,Space Wars,67122729,45058,12416,32642,2022-08-19
4968,Nintendo Technologies,Brand Asset Development,GI-Bro,36103664,45053,26759,18294,2022-02-12
4640,Nintendo Technologies,Brand Asset Development,Space Wars,59934922,44920,39786,5134,2022-02-04
2801,Nintendo Technologies,Brand Asset Development,Merf,58731461,44858,14790,30068,2022-06-26
1264,Meta Platforms,Brand Asset Development,Clay-Dough,59676700,44852,31150,13702,2022-06-27
1947,Google Inc.,Brand Publicity,Clay-Dough,86402817,44827,5881,38946,2022-04-15
4413,Disney Studios,Brand Asset Development,Space Wars,61823609,44777,7384,37393,2022-06-14
4817,Disney Studios,Influencer,Clay-Dough,37006951,44748,30803,13945,2022-01-03
2235,KYG Antler LLC,Brand Publicity,Clay-Dough,40504635,44744,13286,31458,2022-07-02
2763,Meta Platforms,Brand Publicity,Merf,66886442,44734,33398,11336,2022-05-26
3254,Pinterest Inc,Influencer,Transmorphers,60793827,44710,32931,11779,2022-05-15
3574,The Martingale Agency,Influencer,Space Wars,11077544,44681,11475,33206,2022-03-05
153,Nintendo Technologies,E-Commerce,Merf,51107657,44553,8206,36347,2022-07-04
4506,Meta Platforms,Media Supported Asset,Transmorphers,92059508,44464,25212,19252,2022-06-28
4135,TikTok Inc,Brand Publicity,Transmorphers,42615444,44460,8879,35581,2022-09-28
2622,The Martingale Agency,Brand Publicity,Transmorphers,71032786,44459,33275,11184,2022-02-14
16,Pinterest Inc,Brand Asset Development,Clay-Dough,82500011,44453,12232,32221,2022-02-20
3625,KYG Antler LLC,Media Supported Asset,GI-Bro,39093119,44423,16270,28153,2022-09-10
869,Disney Studios,Brand Asset Development,GI-Bro,50333815,44379,5375,39004,2022-07-26
4103,Disney Studios,Influencer,GI-Bro,95116221,44333,16215,28118,2022-09-20
3799,Meta Platforms,E-Commerce,Merf,78539574,44316,27478,16838,2022-04-15
1618,KYG Antler LLC,Brand Publicity,GI-Bro,78177037,44246,31605,12641,2022-02-10
941,Nintendo Technologies,E-Commerce,GI-Bro,44372045,44240,15220,29020,2022-05-11
1140,Disney Studios,Influencer,Space Wars,22431916,44233,30086,14147,2022-03-23
240,Nintendo Technologies,Brand Asset Development,Clay-Dough,90458522,44229,11458,32771,2022-03-25
2691,Disney Studios,Brand Asset Development,Merf,90204418,44223,13465,30758,2022-05-24
1166,Pinterest Inc,Media Supported Asset,Clay-Dough,94326640,44193,4806,39387,2022-05-10
4975,KYG Antler LLC,E-Commerce,Space Wars,70135360,44192,21869,22323,2022-06-12
1076,TikTok Inc,Media Supported Asset,Transmorphers,48110251,44186,5151,39035,2022-06-08
3434,KYG Antler LLC,E-Commerce,Merf,35414110,44170,30503,13667,2022-01-17
4699,Pinterest Inc,E-Commerce,Space Wars,44591221,44168,7166,37002,2022-09-09
2778,Meta Platforms,Media Supported Asset,Space Wars,56661525,44143,5549,38594,2022-09-14
4347,Disney Studios,E-Commerce,Transmorphers,39878013,44142,10323,33819,2022-05-25
85,TikTok Inc,Brand Publicity,Clay-Dough,93386644,44139,32273,11866,2022-02-02
1144,Pinterest Inc,Brand Asset Development,Transmorphers,27876992,44055,8243,35812,2022-01-13
281,Disney Studios,Influencer,Merf,35041974,43966,1369,42597,2022-07-07
950,Google Inc.,Influencer,Clay-Dough,55463728,43961,43012,949,2022-04-07
21,KYG Antler LLC,Brand Publicity,Transmorphers,13816981,43955,9090,34865,2022-08-15
4265,Meta Platforms,Influencer,Merf,98726874,43900,16101,27799,2022-08-03
3941,TikTok Inc,Influencer,GI-Bro,78763802,43870,3885,39985,2022-08-23
2036,Nintendo Technologies,Influencer,Clay-Dough,54139636,43756,17675,26081,2022-06-16
3212,The Martingale Agency,E-Commerce,Space Wars,16188515,43744,7120,36624,2022-04-26
1916,Meta Platforms,Media Supported Asset,Transmorphers,83532745,43730,24486,19244,2022-05-24
2963,Disney Studios,E-Commerce,GI-Bro,73067790,43703,2916,40787,2022-01-09
509,Google Inc.,Influencer,Transmorphers,80865305,43689,1917,41772,2022-07-29
846,KYG Antler LLC,E-Commerce,Merf,97359791,43674,944,42730,2022-08-30
356,Nintendo Technologies,Brand Publicity,Merf,65462728,43652,7611,36041,2022-09-09
3245,Meta Platforms,Influencer,GI-Bro,95570542,43610,3746,39864,2022-07-23
3750,Google Inc.,Brand Publicity,GI-Bro,88812391,43553,20555,22998,2022-04-18
612,The Martingale Agency,Brand Asset Development,Clay-Dough,77465119,43487,4129,39358,2022-01-06
2245,TikTok Inc,Media Supported Asset,Transmorphers,26887927,43478,3865,39613,2022-09-07
2739,Google Inc.,Brand Asset Development,Space Wars,91769831,43478,11078,32400,2022-05-26
3686,Pinterest Inc,Brand Publicity,Merf,11517090,43476,12715,30761,2022-09-21
2475,The Martingale Agency,Media Supported Asset,Merf,93730845,43382,40086,3296,2022-03-14
2369,Pinterest Inc,Influencer,Space Wars,34603438,43368,41515,1853,2022-03-14
4800,KYG Antler LLC,E-Commerce,Space Wars,68415444,43299,9679,33620,2022-08-18
1266,TikTok Inc,Brand Publicity,Merf,58518771,43253,3492,39761,2022-08-17
3325,Pinterest Inc,Media Supported Asset,Transmorphers,85681998,43150,675,42475,2022-07-24
347,KYG Antler LLC,E-Commerce,GI-Bro,99954100,43147,22269,20878,2022-03-26
4403,TikTok Inc,Influencer,Merf,60530510,43124,13199,29925,2022-07-28
3297,Nintendo Technologies,Influencer,Merf,42014839,43083,9959,33124,2022-08-29
1055,TikTok Inc,Media Supported Asset,GI-Bro,32462925,43073,25549,17524,2022-02-22
3355,Nintendo Technologies,Media Supported Asset,Transmorphers,66282637,43038,13133,29905,2022-08-26
4285,Nintendo Technologies,Brand Asset Development,Space Wars,81655380,43034,15101,27933,2022-09-06
1472,Disney Studios,Influencer,Clay-Dough,37566932,43019,210,42809,2022-07-30
4726,TikTok Inc,Influencer,Space Wars,69569690,43015,20738,22277,2022-02-07
4881,Disney Studios,Influencer,Space Wars,72352329,42985,5033,37952,2022-01-31
1829,KYG Antler LLC,E-Commerce,GI-Bro,17814616,42955,26024,16931,2022-06-17
3483,Nintendo Technologies,E-Commerce,Transmorphers,45950779,42955,33546,9409,2022-01-17
3482,Pinterest Inc,E-Commerce,GI-Bro,61868106,42892,9911,32981,2022-09-26
4826,Pinterest Inc,Media Supported Asset,Transmorphers,73728226,42835,13389,29446,2022-04-09
2826,TikTok Inc,Brand Asset Development,Merf,75988976,42823,22505,20318,2022-04-17
3219,Pinterest Inc,Influencer,Space Wars,11934904,42803,21384,21419,2022-06-29
1678,Nintendo Technologies,Influencer,Transmorphers,45297976,42796,16052,26744,2022-03-28
1285,Nintendo Technologies,Brand Publicity,Space Wars,37431899,42766,2758,40008,2022-02-19
208,The Martingale Agency,E-Commerce,Merf,81010675,42748,5224,37524,2022-09-18
1655,Nintendo Technologies,Media Supported Asset,Transmorphers,34597240,42714,11011,31703,2022-06-22
2947,Meta Platforms,Influencer,Clay-Dough,24334196,42673,5272,37401,2022-08-25
3470,Meta Platforms,Media Supported Asset,GI-Bro,86100485,42668,9875,32793,2022-02-09
616,Disney Studios,Brand Publicity,Space Wars,24628481,42619,1844,40775,2022-03-14
44,Meta Platforms,Media Supported Asset,Space Wars,52296961,42556,23693,18863,2022-03-28
3044,Disney Studios,Brand Asset Development,Clay-Dough,91557720,42554,2217,40337,2022-09-26
2030,KYG Antler LLC,Influencer,Transmorphers,60495024,42520,37102,5418,2022-03-02
1927,Disney Studios,Brand Publicity,GI-Bro,28193831,42462,9557,32905,2022-08-24
2568,TikTok Inc,Media Supported Asset,Transmorphers,31283145,42414,7940,34474,2022-07-30
2190,KYG Antler LLC,Brand Publicity,Merf,22242039,42413,15111,27302,2022-09-01
2531,Pinterest Inc,Brand Asset Development,GI-Bro,45690384,42330,6437,35893,2022-02-18
3983,The Martingale Agency,Brand Asset Development,GI-Bro,20770614,42330,35732,6598,2022-02-04
217,KYG Antler LLC,Brand Publicity,Merf,28635213,42327,13864,28463,2022-01-26
3018,Disney Studios,Brand Asset Development,GI-Bro,13600344,42280,42232,48,2022-03-28
3952,Nintendo Technologies,E-Commerce,Clay-Dough,47946699,42197,33934,8263,2022-02-03
1960,TikTok Inc,Brand Publicity,Merf,48495115,42125,36536,5589,2022-01-15
387,Nintendo Technologies,Media Supported Asset,GI-Bro,70236829,42086,20366,21720,2022-01-24
4288,Nintendo Technologies,Media Supported Asset,Merf,23280478,42060,7021,35039,2022-07-14
354,TikTok Inc,Brand Asset Development,GI-Bro,31608963,42060,33779,8281,2022-03-24
3135,The Martingale Agency,Influencer,Space Wars,85060408,41997,15635,26362,2022-08-03
1310,Meta Platforms,E-Commerce,GI-Bro,86412250,41972,9485,32487,2022-04-03
4187,Google Inc.,E-Commerce,Transmorphers,99741964,41942,16467,25475,2022-08-21
436,KYG Antler LLC,Media Supported Asset,Transmorphers,86973365,41892,2082,39810,2022-09-05
2845,Meta Platforms,Brand Asset Development,Space Wars,49114481,41881,16750,25131,2022-09-25
2833,The Martingale Agency,Brand Asset Development,GI-Bro,44279307,41845,40189,1656,2022-06-06
2093,TikTok Inc,Brand Publicity,Clay-Dough,33179888,41819,22638,19181,2022-04-30
185,Meta Platforms,Influencer,Merf,14329291,41746,16179,25567,2022-09-21
2000,Google Inc.,Brand Publicity,Transmorphers,72570611,41720,38848,2872,2022-03-12
1147,TikTok Inc,E-Commerce,Space Wars,62318682,41619,20928,20691,2022-03-16
1301,Google Inc.,E-Commerce,GI-Bro,37680106,41557,39501,2056,2022-03-04
3873,The Martingale Agency,Brand Asset Development,GI-Bro,30142904,41537,930,40607,2022-08-04
4618,Google Inc.,Media Supported Asset,Transmorphers,79869505,41505,26898,14607,2022-05-29
3932,KYG Antler LLC,Influencer,Merf,91969911,41483,6048,35435,2022-02-12
2243,Nintendo Technologies,Influencer,Space Wars,31823453,41455,4748,36707,2022-09-16
4655,Google Inc.,Brand Asset Development,GI-Bro,90249012,41430,40402,1028,2022-01-19
50,Meta Platforms,Brand Asset Development,Transmorphers,56850716,41363,9246,32117,2022-05-20
1174,Meta Platforms,Brand Asset Development,Clay-Dough,60924763,41357,4711,36646,2022-09-02
325,KYG Antler LLC,Influencer,Transmorphers,81572608,41353,3075,38278,2022-09-09
1533,Pinterest Inc,Influencer,Clay-Dough,62067703,41310,9350,31960,2022-09-01
4381,Meta Platforms,E-Commerce,Space Wars,32357521,41288,14859,26429,2022-04-10
1094,Disney Studios,E-Commerce,Space Wars,13995663,41277,31798,9479,2022-06-04
1620,Disney Studios,Influencer,Space Wars,48117418,41270,2396,38874,2022-07-26
1331,Disney Studios,E-Commerce,Space Wars,83082934,41193,36416,4777,2022-01-18
3436,TikTok Inc,Brand Asset Development,Merf,69326572,41183,38488,2695,2022-01-26
1410,The Martingale Agency,Influencer,GI-Bro,50409492,41138,181,40957,2022-07-25
1451,Pinterest Inc,E-Commerce,Merf,99763918,41071,5047,36024,2022-09-11
2612,Disney Studios,Brand Publicity,GI-Bro,14740753,41067,6825,34242,2022-01-21
4029,Pinterest Inc,Influencer,Clay-Dough,11009910,41054,11265,29789,2022-09-13
1695,Pinterest Inc,Influencer,Merf,19250607,41018,25561,15457,2022-04-03
2748,Disney Studios,Brand Asset Development,GI-Bro,21261497,41012,15554,25458,2022-08-20
2553,Disney Studios,E-Commerce,Transmorphers,41792023,41003,391,40612,2022-08-22
1008,Disney Studios,Influencer,GI-Bro,62028962,40990,29400,11590,2022-03-29
3741,The Martingale Agency,Media Supported Asset,Clay-Dough,58859470,40984,12698,28286,2022-09-11
202,The Martingale Agency,Influencer,Clay-Dough,15397438,40983,13766,27217,2022-09-01
4335,The Martingale Agency,Brand Asset Development,GI-Bro,67828219,40980,3542,37438,2022-05-25
4921,Disney Studios,E-Commerce,Merf,20402054,40970,25229,15741,2022-02-15
2025,TikTok Inc,Influencer,GI-Bro,16852538,40947,31947,9000,2022-06-05
4055,Nintendo Technologies,Media Supported Asset,Merf,87861165,40905,10908,29997,2022-08-01
1276,The Martingale Agency,E-Commerce,GI-Bro,60536971,40895,6682,34213,2022-03-01
4752,Nintendo Technologies,Brand Asset Development,GI-Bro,36552824,40870,16517,24353,2022-05-31
1158,Nintendo Technologies,Influencer,Clay-Dough,39605852,40860,11878,28982,2022-03-07
3294,Pinterest Inc,Brand Asset Development,Clay-Dough,40433927,40856,34773,6083,2022-01-27
4904,TikTok Inc,E-Commerce,GI-Bro,45947547,40827,26587,14240,2022-06-02
4256,Pinterest Inc,Brand Publicity,Transmorphers,14551339,40806,18457,22349,2022-01-05
2646,TikTok Inc,Influencer,Clay-Dough,56169497,40797,3178,37619,2022-03-21
2944,The Martingale Agency,Influencer,Space Wars,27038649,40795,16609,24186,2022-06-27
2819,TikTok Inc,Media Supported Asset,Merf,94652489,40793,9922,30871,2022-01-10
513,TikTok Inc,Brand Asset Development,GI-Bro,46646622,40781,4317,36464,2022-07-16
3669,TikTok Inc,Influencer,Merf,51239258,40779,34862,5917,2022-01-08
3464,TikTok Inc,Brand Asset Development,Merf,39136479,40741,13173,27568,2022-09-13
3309,The Martingale Agency,Brand Publicity,Transmorphers,61603206,40739,11522,29217,2022-01-12
2723,TikTok Inc,Influencer,Space Wars,73615059,40730,2667,38063,2022-08-22
1701,Google Inc.,Influencer,GI-Bro,91402454,40725,25034,15691,2022-05-29
4961,Meta Platforms,E-Commerce,Clay-Dough,95353078,40713,5045,35668,2022-09-29
1939,TikTok Inc,Brand Publicity,Clay-Dough,47855795,40631,22990,17641,2022-05-18
983,KYG Antler LLC,Influencer,Merf,92091627,40615,6534,34081,2022-04-22
4445,The Martingale Agency,E-Commerce,GI-Bro,51302547,40598,978,39620,2022-07-25
660,Nintendo Technologies,Brand Asset Development,GI-Bro,77696876,40578,38025,2553,2022-03-20
3316,Disney Studios,Brand Asset Development,GI-Bro,42008117,40571,39111,1460,2022-04-17
670,The Martingale Agency,Brand Publicity,Space Wars,46427407,40544,39882,662,2022-06-16
3804,Google Inc.,Brand Asset Development,Transmorphers,38339954,40541,6049,34492,2022-08-06
3222,Nintendo Technologies,Brand Publicity,GI-Bro,42554064,40537,12234,28303,2022-07-29
1568,Google Inc.,E-Commerce,GI-Bro,13874263,40516,26424,14092,2022-06-10
1121,Pinterest Inc,E-Commerce,Merf,64531382,40441,36972,3469,2022-04-02
3484,Meta Platforms,Brand Publicity,Merf,11291714,40436,29672,10764,2022-06-29
3252,Disney Studios,Brand Publicity,Space Wars,56774193,40433,30024,10409,2022-01-21
2353,KYG Antler LLC,Brand Asset Development,Space Wars,74020520,40420,11626,28794,2022-08-30
3887,Pinterest Inc,Brand Asset Development,Transmorphers,59446086,40360,11860,28500,2022-01-30
2232,KYG Antler LLC,E-Commerce,Space Wars,81979992,40283,33392,6891,2022-05-24
2891,Nintendo Technologies,E-Commerce,Merf,96655436,40275,31894,8381,2022-06-23
1968,The Martingale Agency,E-Commerce,GI-Bro,84554020,40261,18027,22234,2022-05-01
247,Pinterest Inc,Influencer,Transmorphers,11627114,40254,38553,1701,2022-01-09
3064,KYG Antler LLC,Influencer,Clay-Dough,88025546,40252,1409,38843,2022-07-22
1286,Meta Platforms,Brand Asset Development,Merf,92518741,40242,28176,12066,2022-01-20
2937,TikTok Inc,Brand Asset Development,Merf,46379716,40226,33815,6411,2022-02-23
1958,KYG Antler LLC,Influencer,Clay-Dough,63805223,40208,6124,34084,2022-01-08
1216,TikTok Inc,Influencer,Merf,61145702,40164,29743,10421,2022-01-05
2264,KYG Antler LLC,Brand Asset Development,Transmorphers,29438609,40160,6919,33241,2022-07-05
2244,KYG Antler LLC,Media Supported Asset,Transmorphers,31416572,40144,1870,38274,2022-08-31
2791,KYG Antler LLC,Brand Publicity,Space Wars,85529927,40041,5562,34479,2022-09-03
799,Nintendo Technologies,E-Commerce,Space Wars,31196232,39978,22625,17353,2022-04-15
3019,Pinterest Inc,Influencer,GI-Bro,68092887,39945,10354,29591,2022-07-04
711,Meta Platforms,Brand Asset Development,Clay-Dough,82445729,39918,24517,15401,2022-06-30
4431,Google Inc.,Influencer,Clay-Dough,77803188,39893,23383,16510,2022-01-14
4107,KYG Antler LLC,Media Supported Asset,Merf,93162051,39847,18948,20899,2022-03-03
345,Google Inc.,E-Commerce,Merf,61036919,39823,14631,25192,2022-06-28
2842,TikTok Inc,Influencer,Clay-Dough,75953117,39815,2001,37814,2022-08-18
1305,The Martingale Agency,Media Supported Asset,GI-Bro,72484391,39805,14482,25323,2022-09-17
2888,The Martingale Agency,E-Commerce,GI-Bro,30916467,39801,5760,34041,2022-04-16
4777,KYG Antler LLC,Influencer,Transmorphers,75901152,39764,37017,2747,2022-05-16
3233,Pinterest Inc,E-Commerce,Space Wars,45321679,39763,12757,27006,2022-03-24
4326,Meta Platforms,Media Supported Asset,GI-Bro,80939067,39752,22840,16912,2022-05-29
3054,Google Inc.,Brand Asset Development,GI-Bro,70367504,39744,31639,8105,2022-04-29
900,The Martingale Agency,Brand Publicity,Space Wars,37961114,39729,7433,32296,2022-08-04
3613,Google Inc.,Brand Asset Development,Merf,46540322,39725,9741,29984,2022-09-01
3867,KYG Antler LLC,E-Commerce,Merf,57142364,39721,6120,33601,2022-02-01
2761,Google Inc.,Media Supported Asset,Merf,57243055,39708,27796,11912,2022-01-14
922,TikTok Inc,Influencer,Space Wars,15947674,39701,27432,12269,2022-06-20
4922,Nintendo Technologies,Influencer,Clay-Dough,75635923,39644,11176,28468,2022-08-16
2385,The Martingale Agency,Brand Asset Development,Transmorphers,77289273,39638,6228,33410,2022-04-16
2698,Pinterest Inc,Influencer,Space Wars,73349053,39635,30514,9121,2022-06-20
2252,Meta Platforms,Media Supported Asset,Clay-Dough,78449226,39615,4240,35375,2022-08-07
3188,Disney Studios,Brand Asset Development,Clay-Dough,23343466,39603,13469,26134,2022-08-23
3441,TikTok Inc,Brand Publicity,Merf,86769866,39562,5710,33852,2022-07-20
2204,Meta Platforms,Influencer,Clay-Dough,12613119,39548,11226,28322,2022-07-28
3685,Google Inc.,Influencer,Transmorphers,12509414,39520,4303,35217,2022-06-28
940,The Martingale Agency,Brand Asset Development,Transmorphers,45946184,39494,31363,8131,2022-05-30
1244,The Martingale Agency,Brand Asset Development,Clay-Dough,88714617,39455,31145,8310,2022-01-30
2871,Disney Studios,Brand Asset Development,Transmorphers,13505166,39400,4892,34508,2022-03-17
628,Nintendo Technologies,Brand Publicity,Clay-Dough,68581552,39375,33650,5725,2022-06-29
2113,KYG Antler LLC,Brand Publicity,GI-Bro,66552685,39335,8226,31109,2022-08-11
3166,The Martingale Agency,Media Supported Asset,Transmorphers,54655493,39334,14064,25270,2022-07-25
790,Nintendo Technologies,Brand Publicity,Clay-Dough,62901511,39326,636,38690,2022-08-01
2508,Pinterest Inc,Media Supported Asset,Clay-Dough,64126480,39267,14654,24613,2022-03-28
459,Google Inc.,Influencer,Merf,62822732,39229,22765,16464,2022-02-06
230,Google Inc.,Brand Asset Development,Transmorphers,29741264,39212,11328,27884,2022-07-10
4163,Google Inc.,Media Supported Asset,Merf,14366897,39186,30421,8765,2022-05-29
4609,Meta Platforms,Influencer,Clay-Dough,68564801,39136,8429,30707,2022-08-16
1929,Google Inc.,E-Commerce,Space Wars,95419862,39081,10708,28373,2022-03-03
560,Meta Platforms,Influencer,Transmorphers,52453172,39012,30510,8502,2022-05-31
2652,TikTok Inc,E-Commerce,Merf,66124913,39004,3110,35894,2022-05-02
305,Disney Studios,E-Commerce,GI-Bro,55307292,39001,12489,26512,2022-08-15
647,Pinterest Inc,Brand Asset Development,Merf,82573264,38992,7836,31156,2022-02-28
3515,Pinterest Inc,Brand Publicity,GI-Bro,88658887,38969,4880,34089,2022-03-31
406,Nintendo Technologies,Influencer,Clay-Dough,34014850,38931,36404,2527,2022-03-22
588,KYG Antler LLC,E-Commerce,Clay-Dough,28572280,38916,8735,30181,2022-08-09
3992,Google Inc.,Brand Asset Development,Transmorphers,44520051,38903,15198,23705,2022-04-30
3369,Disney Studios,Influencer,GI-Bro,48046150,38885,32566,6319,2022-06-10
2758,Meta Platforms,Brand Publicity,Merf,61465711,38875,9515,29360,2022-08-06
2219,KYG Antler LLC,Influencer,Transmorphers,17463780,38859,10959,27900,2022-04-23
2109,Pinterest Inc,Influencer,Clay-Dough,37417717,38836,33037,5799,2022-04-27
268,Google Inc.,Media Supported Asset,GI-Bro,12555982,38830,2043,36787,2022-04-29
2359,Pinterest Inc,Influencer,Transmorphers,91784717,38829,15398,23431,2022-03-16
4012,Nintendo Technologies,E-Commerce,Transmorphers,76520248,38806,7254,31552,2022-03-18
2863,Meta Platforms,Brand Asset Development,Merf,91028733,38791,7967,30824,2022-08-17
4647,Meta Platforms,Media Supported Asset,GI-Bro,37958644,38752,7586,31166,2022-03-29
3333,KYG Antler LLC,Brand Asset Development,Transmorphers,70355487,38680,33522,5158,2022-05-30
1514,The Martingale Agency,Media Supported Asset,Space Wars,15624734,38640,7991,30649,2022-07-25
823,Disney Studios,Brand Publicity,Clay-Dough,51109580,38638,19347,19291,2022-05-17
703,The Martingale Agency,E-Commerce,GI-Bro,33504341,38637,8790,29847,2022-09-07
2089,The Martingale Agency,Brand Publicity,Transmorphers,90107375,38590,7116,31474,2022-03-16
754,Meta Platforms,E-Commerce,Space Wars,67216464,38564,24893,13671,2022-05-06
3180,TikTok Inc,Media Supported Asset,GI-Bro,55922049,38550,10096,28454,2022-07-01
4151,Disney Studios,E-Commerce,GI-Bro,19488347,38540,694,37846,2022-07-03
444,Nintendo Technologies,Brand Publicity,Space Wars,37219264,38533,3190,35343,2022-04-06
4867,Google Inc.,E-Commerce,GI-Bro,44051357,38530,25585,12945,2022-01-06
3300,Nintendo Technologies,Influencer,Transmorphers,29160763,38526,21901,16625,2022-03-14
1325,Pinterest Inc,Brand Publicity,Space Wars,57046496,38502,24293,14209,2022-04-03
805,Nintendo Technologies,Brand Asset Development,GI-Bro,93511192,38494,14255,24239,2022-04-16
4487,Meta Platforms,Brand Publicity,Space Wars,88354598,38481,6031,32450,2022-09-26
701,Disney Studios,Media Supported Asset,Space Wars,76197099,38404,19292,19112,2022-01-21
3234,Google Inc.,Brand Publicity,GI-Bro,58692765,38369,12876,25493,2022-01-01
4153,Disney Studios,Brand Asset Development,Merf,88956708,38364,30779,7585,2022-03-08
4541,Google Inc.,E-Commerce,Transmorphers,29641582,38310,1717,36593,2022-05-03
303,Disney Studios,Brand Publicity,GI-Bro,61269537,38235,9081,29154,2022-07-27
2187,KYG Antler LLC,Media Supported Asset,Transmorphers,88661010,38213,37829,384,2022-02-05
2526,Nintendo Technologies,Media Supported Asset,GI-Bro,35725237,38181,21860,16321,2022-04-06
1156,TikTok Inc,Brand Asset Development,Space Wars,83151642,38153,1590,36563,2022-03-07
4456,Nintendo Technologies,Media Supported Asset,Space Wars,35491244,38141,9758,28383,2022-05-13
4883,Meta Platforms,Brand Asset Development,Merf,15386540,38133,10797,27336,2022-05-29
1386,Meta Platforms,Media Supported Asset,Transmorphers,76241667,38131,27357,10774,2022-05-03
1142,The Martingale Agency,Brand Asset Development,Merf,17796852,38127,26465,11662,2022-06-02
115,Meta Platforms,E-Commerce,Transmorphers,10008215,38105,34634,3471,2022-06-13
2251,TikTok Inc,Media Supported Asset,GI-Bro,92246762,38092,21900,16192,2022-05-11
2663,Nintendo Technologies,Brand Asset Development,Merf,15653843,38070,19242,18828,2022-01-13
2240,Google Inc.,Brand Asset Development,Clay-Dough,22127202,38057,7257,30800,2022-05-01
3689,The Martingale Agency,Media Supported Asset,GI-Bro,56570755,38047,5237,32810,2022-09-29
483,Google Inc.,Brand Asset Development,Merf,10387474,38011,9882,28129,2022-09-27
4463,TikTok Inc,Influencer,Clay-Dough,98784334,37989,3325,34664,2022-07-06
380,Google Inc.,Brand Asset Development,Clay-Dough,72317081,37982,16145,21837,2022-06-19
4825,The Martingale Agency,Influencer,Space Wars,53738977,37946,18006,19940,2022-04-21
2023,Nintendo Technologies,Brand Publicity,Clay-Dough,86381642,37896,26751,11145,2022-05-03
2159,KYG Antler LLC,E-Commerce,Transmorphers,15802433,37895,2530,35365,2022-08-11
1366,The Martingale Agency,E-Commerce,Merf,37947034,37866,36889,977,2022-06-08
4428,The Martingale Agency,Brand Publicity,Transmorphers,83351169,37845,30511,7334,2022-01-18
1517,Nintendo Technologies,Media Supported Asset,Transmorphers,30256075,37810,7428,30382,2022-03-11
2831,KYG Antler LLC,Media Supported Asset,Merf,66503298,37804,1788,36016,2022-07-01
2426,Google Inc.,Influencer,Transmorphers,36229786,37779,32242,5537,2022-02-12
516,The Martingale Agency,Brand Publicity,Transmorphers,47383477,37735,11634,26101,2022-07-14
4079,Meta Platforms,E-Commerce,Space Wars,16293740,37698,15060,22638,2022-01-02
3340,KYG Antler LLC,Media Supported Asset,Transmorphers,86690859,37691,9166,28525,2022-08-22
2380,Disney Studios,E-Commerce,Transmorphers,63303970,37677,19984,17693,2022-04-14
367,Meta Platforms,Brand Asset Development,Clay-Dough,67659449,37655,26415,11240,2022-04-10
3046,Google Inc.,E-Commerce,GI-Bro,76382379,37653,34638,3015,2022-06-06
498,Nintendo Technologies,Media Supported Asset,Merf,42050534,37651,31864,5787,2022-01-15
140,KYG Antler LLC,Influencer,Merf,79500977,37643,18686,18957,2022-03-24
3276,Nintendo Technologies,Influencer,Merf,65137300,37601,3416,34185,2022-06-28
1389,Pinterest Inc,Brand Publicity,Merf,85116747,37521,10102,27419,2022-08-21
3742,Meta Platforms,E-Commerce,Transmorphers,43721644,37507,8537,28970,2022-01-24
3208,Google Inc.,Media Supported Asset,Space Wars,46794969,37430,31309,6121,2022-01-18
2534,Pinterest Inc,Media Supported Asset,GI-Bro,86067510,37408,19028,18380,2022-02-25
6,Nintendo Technologies,Brand Publicity,Space Wars,14518414,37277,11272,26005,2022-05-26
2730,TikTok Inc,Media Supported Asset,Transmorphers,90183009,37220,23010,14210,2022-03-26
3660,Disney Studios,Brand Asset Development,Clay-Dough,74787952,37211,8424,28787,2022-07-12
4289,TikTok Inc,E-Commerce,GI-Bro,54562528,37157,4627,32530,2022-03-12
4797,Disney Studios,Influencer,Clay-Dough,14510588,37156,519,36637,2022-07-21
274,The Martingale Agency,E-Commerce,Transmorphers,37864108,37154,5797,31357,2022-08-27
843,Nintendo Technologies,Brand Publicity,Clay-Dough,38034138,37150,5098,32052,2022-07-16
4742,TikTok Inc,Media Supported Asset,Clay-Dough,65547315,37137,946,36191,2022-06-28
515,Nintendo Technologies,Media Supported Asset,Clay-Dough,21752484,37050,5922,31128,2022-03-30
439,Disney Studios,Brand Publicity,GI-Bro,57297618,37019,890,36129,2022-08-09
195,Pinterest Inc,Brand Publicity,Merf,83182635,36989,6647,30342,2022-09-16
893,Pinterest Inc,Media Supported Asset,GI-Bro,50129540,36989,2343,34646,2022-02-18
1597,Pinterest Inc,Brand Publicity,Clay-Dough,72754704,36982,8162,28820,2022-07-30
2333,Nintendo Technologies,Brand Asset Development,Merf,58046117,36957,13631,23326,2022-04-08
1125,Pinterest Inc,Influencer,Merf,88226405,36918,5335,31583,2022-01-11
3853,The Martingale Agency,Influencer,Space Wars,49277894,36915,18253,18662,2022-02-21
4077,Disney Studios,Brand Asset Development,GI-Bro,33074751,36906,9678,27228,2022-08-14
1409,Google Inc.,E-Commerce,Transmorphers,56047236,36848,5382,31466,2022-08-12
4499,Meta Platforms,Media Supported Asset,GI-Bro,66161250,36834,18503,18331,2022-01-14
1009,Pinterest Inc,Brand Asset Development,Clay-Dough,51231013,36813,269,36544,2022-08-24
3601,TikTok Inc,Influencer,Merf,84301668,36811,10416,26395,2022-02-20
1621,Pinterest Inc,Influencer,Transmorphers,23320117,36795,15874,20921,2022-03-03
3895,Nintendo Technologies,Brand Asset Development,GI-Bro,99935234,36710,10675,26035,2022-08-08
1938,TikTok Inc,Media Supported Asset,Clay-Dough,79051535,36675,9595,27080,2022-08-07
342,Pinterest Inc,Brand Publicity,Space Wars,87496959,36659,6156,30503,2022-07-15
608,KYG Antler LLC,Brand Asset Development,Merf,73252598,36575,6150,30425,2022-07-26
3735,KYG Antler LLC,Media Supported Asset,Clay-Dough,44186128,36572,2171,34401,2022-02-23
1277,The Martingale Agency,Brand Publicity,Transmorphers,72040740,36565,20100,16465,2022-02-20
1548,Google Inc.,Influencer,Space Wars,50946477,36556,7555,29001,2022-07-25
1044,Meta Platforms,Influencer,Clay-Dough,62131487,36554,20927,15627,2022-05-06
1405,TikTok Inc,Influencer,Space Wars,51466054,36545,4626,31919,2022-05-05
3996,Nintendo Technologies,Media Supported Asset,Clay-Dough,35136873,36484,10879,25605,2022-08-01
2302,The Martingale Agency,Brand Asset Development,Space Wars,48241440,36413,14214,22199,2022-06-02
1206,Google Inc.,Media Supported Asset,Transmorphers,72867381,36343,15145,21198,2022-02-06
2290,Pinterest Inc,Influencer,Space Wars,97906190,36296,5629,30667,2022-08-31
3599,Meta Platforms,Brand Asset Development,GI-Bro,29195641,36292,4663,31629,2022-09-02
3230,Nintendo Technologies,Influencer,GI-Bro,74878975,36288,16224,20064,2022-01-18
3570,Google Inc.,Brand Publicity,Transmorphers,15186622,36260,12176,24084,2022-02-03
3968,Pinterest Inc,Media Supported Asset,Space Wars,97170504,36245,22836,13409,2022-03-07
3819,KYG Antler LLC,Brand Asset Development,Space Wars,12702127,36235,3181,33054,2022-09-11
519,Google Inc.,E-Commerce,Clay-Dough,49255351,36221,34925,1296,2022-02-06
120,Google Inc.,Brand Publicity,Space Wars,68793247,36200,5763,30437,2022-04-07
3255,Google Inc.,Brand Publicity,GI-Bro,13423892,36152,25043,11109,2022-03-13
2026,Disney Studios,E-Commerce,Space Wars,77435076,36072,4236,31836,2022-06-05
4332,The Martingale Agency,Media Supported Asset,Clay-Dough,16253214,36066,1068,34998,2022-03-27
817,TikTok Inc,E-Commerce,Transmorphers,15526720,36033,13052,22981,2022-02-23
390,Nintendo Technologies,Brand Publicity,GI-Bro,73830197,36031,623,35408,2022-09-16
4035,The Martingale Agency,Brand Asset Development,Merf,71048036,35927,28982,6945,2022-04-09
2966,Google Inc.,Brand Asset Development,Transmorphers,43194095,35873,4690,31183,2022-08-30
2487,Meta Platforms,E-Commerce,Merf,92102933,35857,23614,12243,2022-05-30
3299,Meta Platforms,E-Commerce,GI-Bro,12952868,35823,9300,26523,2022-07-08
74,Nintendo Technologies,Influencer,Transmorphers,89826763,35816,12988,22828,2022-06-18
1197,Disney Studios,Brand Asset Development,Merf,25437470,35800,3282,32518,2022-03-20
4505,Pinterest Inc,Media Supported Asset,Clay-Dough,53432755,35772,33218,2554,2022-03-22
1476,The Martingale Agency,Influencer,Space Wars,39620998,35752,7536,28216,2022-08-17
4691,Disney Studios,Media Supported Asset,Space Wars,68293359,35748,21491,14257,2022-03-08
1866,Disney Studios,E-Commerce,GI-Bro,38124953,35725,1822,33903,2022-01-06
4246,Pinterest Inc,Brand Publicity,Clay-Dough,56465921,35723,4010,31713,2022-04-07
2098,KYG Antler LLC,Influencer,Space Wars,76333332,35679,3446,32233,2022-07-19
166,Nintendo Technologies,Media Supported Asset,Space Wars,93849289,35599,32958,2641,2022-06-14
1569,Google Inc.,Influencer,GI-Bro,94186447,35534,20142,15392,2022-01-07
3725,TikTok Inc,Brand Publicity,Clay-Dough,60890059,35514,28672,6842,2022-04-14
1788,Meta Platforms,Media Supported Asset,Merf,35560093,35460,24964,10496,2022-06-24
3924,Pinterest Inc,Media Supported Asset,Space Wars,43198160,35456,25140,10316,2022-03-25
2002,Google Inc.,Media Supported Asset,Clay-Dough,23614518,35434,10148,25286,2022-08-14
3856,Nintendo Technologies,Media Supported Asset,Space Wars,78740206,35366,28025,7341,2022-06-05
2152,The Martingale Agency,Influencer,Merf,30143071,35362,443,34919,2022-04-16
1669,Google Inc.,Brand Publicity,Transmorphers,58804593,35359,1134,34225,2022-09-12
2437,Google Inc.,E-Commerce,Clay-Dough,82358477,35358,16394,18964,2022-01-20
1538,Disney Studios,Brand Publicity,Merf,58476818,35335,26485,8850,2022-04-23
1870,KYG Antler LLC,Media Supported Asset,Transmorphers,74585611,35327,6121,29206,2022-08-09
1966,Disney Studios,E-Commerce,Merf,89025463,35313,6170,29143,2022-09-22
712,Disney Studios,E-Commerce,Transmorphers,65981615,35279,25299,9980,2022-01-29
4262,Nintendo Technologies,Brand Publicity,GI-Bro,14460161,35278,25786,9492,2022-01-14
3319,Nintendo Technologies,Media Supported Asset,GI-Bro,38079373,35211,13950,21261,2022-04-25
959,Disney Studios,Brand Asset Development,Merf,97569631,35194,1300,33894,2022-08-29
3487,Nintendo Technologies,Brand Publicity,Merf,27472583,35083,1507,33576,2022-08-26
2106,TikTok Inc,Brand Asset Development,GI-Bro,97041582,35034,8309,26725,2022-09-01
2438,Pinterest Inc,Influencer,Clay-Dough,51514913,34992,3246,31746,2022-09-03
4228,TikTok Inc,E-Commerce,Merf,54963806,34974,157,34817,2022-09-30
578,Google Inc.,Media Supported Asset,Space Wars,15824257,34938,34075,863,2022-06-30
706,TikTok Inc,E-Commerce,Transmorphers,74998201,34931,26589,8342,2022-02-08
3136,Nintendo Technologies,Influencer,GI-Bro,97967350,34901,8093,26808,2022-03-26
1712,KYG Antler LLC,Brand Asset Development,Transmorphers,74840780,34894,3658,31236,2022-01-22
2556,The Martingale Agency,E-Commerce,Clay-Dough,54321700,34879,33968,911,2022-04-17
3001,Disney Studios,Influencer,Space Wars,16542943,34859,31915,2944,2022-05-25
3703,Meta Platforms,Media Supported Asset,Clay-Dough,97767912,34835,9587,25248,2022-09-24
635,KYG Antler LLC,Brand Asset Development,Transmorphers,21333877,34832,8446,26386,2022-04-22
3781,Google Inc.,Brand Publicity,Clay-Dough,29229575,34830,5255,29575,2022-09-09
671,KYG Antler LLC,E-Commerce,GI-Bro,53126613,34821,22707,12114,2022-02-20
3069,Nintendo Technologies,Brand Asset Development,Transmorphers,56890628,34794,6666,28128,2022-04-13
2764,Disney Studios,Media Supported Asset,Transmorphers,55173194,34764,5220,29544,2022-02-17
336,The Martingale Agency,Brand Asset Development,Transmorphers,31499717,34748,5099,29649,2022-02-20
3360,KYG Antler LLC,Media Supported Asset,GI-Bro,34273478,34740,23379,11361,2022-03-31
205,Google Inc.,E-Commerce,Merf,78286964,34739,7975,26764,2022-07-28
2909,TikTok Inc,Brand Asset Development,GI-Bro,12855713,34736,15572,19164,2022-02-28
1990,Google Inc.,Media Supported Asset,Clay-Dough,84869970,34731,8936,25795,2022-07-04
2743,KYG Antler LLC,Media Supported Asset,GI-Bro,26744403,34695,3923,30772,2022-04-04
3594,TikTok Inc,Brand Publicity,Merf,20777697,34641,3061,31580,2022-07-19
4316,Nintendo Technologies,Brand Asset Development,Merf,39069259,34561,387,34174,2022-04-11
759,KYG Antler LLC,Brand Asset Development,Transmorphers,88934082,34552,6421,28131,2022-07-29
1059,Pinterest Inc,E-Commerce,Merf,67521870,34529,5039,29490,2022-08-21
4296,The Martingale Agency,Media Supported Asset,Transmorphers,56597253,34472,20674,13798,2022-01-17
4205,TikTok Inc,Influencer,Merf,25659869,34467,24973,9494,2022-06-23
1381,Nintendo Technologies,Influencer,Transmorphers,18736601,34445,28637,5808,2022-02-18
4025,The Martingale Agency,Brand Asset Development,Space Wars,28997750,34433,24947,9486,2022-03-27
2034,Meta Platforms,Media Supported Asset,Merf,21534175,34381,19899,14482,2022-03-16
4170,Google Inc.,Influencer,Clay-Dough,59201509,34381,11690,22691,2022-04-01
4992,The Martingale Agency,Brand Asset Development,Transmorphers,57640049,34263,5150,29113,2022-09-20
1564,The Martingale Agency,Brand Asset Development,Transmorphers,21894152,34248,11669,22579,2022-03-05
658,Meta Platforms,Media Supported Asset,Transmorphers,44271679,34204,265,33939,2022-04-06
1541,Google Inc.,E-Commerce,Transmorphers,34690770,34174,25386,8788,2022-02-11
2979,Nintendo Technologies,Brand Publicity,Space Wars,24552722,34174,3027,31147,2022-09-29
783,The Martingale Agency,Media Supported Asset,Merf,69313001,34170,30703,3467,2022-01-08
4363,Google Inc.,E-Commerce,GI-Bro,36890142,34153,34109,44,2022-04-08
2092,Nintendo Technologies,Brand Publicity,Transmorphers,77422739,34000,6708,27292,2022-06-19
4109,Google Inc.,Media Supported Asset,Clay-Dough,51479354,33974,7049,26925,2022-08-02
1096,Meta Platforms,Media Supported Asset,Transmorphers,86187481,33900,67,33833,2022-08-26
2594,Meta Platforms,E-Commerce,Transmorphers,48748225,33899,23831,10068,2022-06-21
4402,KYG Antler LLC,Media Supported Asset,Clay-Dough,39680137,33810,2761,31049,2022-08-15
1454,Nintendo Technologies,Influencer,Space Wars,52476652,33790,22148,11642,2022-06-23
4028,TikTok Inc,Influencer,Clay-Dough,99827822,33785,3640,30145,2022-08-21
1430,Disney Studios,Influencer,Space Wars,92876464,33778,1557,32221,2022-08-08
3997,The Martingale Agency,Brand Publicity,Transmorphers,94593326,33762,14978,18784,2022-01-16
1010,Nintendo Technologies,Media Supported Asset,Transmorphers,16473883,33761,32496,1265,2022-05-20
3989,KYG Antler LLC,Brand Publicity,GI-Bro,11969841,33687,524,33163,2022-09-04
3976,Disney Studios,Brand Asset Development,Clay-Dough,92143264,33658,5823,27835,2022-07-12
2336,The Martingale Agency,Brand Asset Development,GI-Bro,52712729,33649,23922,9727,2022-01-19
835,Nintendo Technologies,Media Supported Asset,GI-Bro,29619626,33543,32873,670,2022-02-06
4952,Pinterest Inc,Brand Publicity,Clay-Dough,97198694,33515,4960,28555,2022-04-07
164,The Martingale Agency,Influencer,Transmorphers,35249417,33512,4724,28788,2022-08-31
3796,Meta Platforms,Brand Publicity,Transmorphers,14300427,33509,8847,24662,2022-03-02
3542,Disney Studios,Influencer,Space Wars,83587090,33508,5201,28307,2022-09-14
1215,Google Inc.,Brand Asset Development,GI-Bro,61974440,33487,813,32674,2022-09-15
3444,Pinterest Inc,Brand Asset Development,Clay-Dough,72505223,33450,18938,14512,2022-03-06
1969,Disney Studios,Brand Asset Development,Merf,12249235,33418,16948,16470,2022-01-19
3811,Pinterest Inc,Media Supported Asset,GI-Bro,79674764,33416,15162,18254,2022-06-04
3007,TikTok Inc,Brand Publicity,Space Wars,46684953,33405,7964,25441,2022-07-28
2729,TikTok Inc,Brand Asset Development,GI-Bro,46608989,33403,4100,29303,2022-07-24
1293,Disney Studios,Media Supported Asset,Space Wars,97743816,33377,8678,24699,2022-03-01
4857,Pinterest Inc,Influencer,Transmorphers,85213962,33333,7180,26153,2022-07-18
1735,Disney Studios,Brand Asset Development,GI-Bro,10021142,33309,11656,21653,2022-06-11
2620,Google Inc.,Media Supported Asset,Transmorphers,50287724,33273,1678,31595,2022-09-26
488,Google Inc.,Media Supported Asset,Merf,37084677,33263,31755,1508,2022-06-24
4379,Pinterest Inc,Media Supported Asset,Merf,49861986,33216,7122,26094,2022-04-09
4574,Meta Platforms,E-Commerce,Merf,53945501,33206,27030,6176,2022-05-21
3558,TikTok Inc,Brand Publicity,Transmorphers,39854102,33180,28346,4834,2022-03-12
1824,Google Inc.,Media Supported Asset,Space Wars,93612009,33142,9245,23897,2022-01-17
1923,TikTok Inc,Influencer,Space Wars,82683991,33126,2430,30696,2022-07-21
1407,TikTok Inc,Media Supported Asset,Space Wars,33816727,33012,3393,29619,2022-07-31
2012,Pinterest Inc,E-Commerce,Clay-Dough,67926904,33001,22532,10469,2022-04-17
2840,Meta Platforms,Brand Publicity,GI-Bro,67405248,32989,1017,31972,2022-07-27
3154,The Martingale Agency,Media Supported Asset,Clay-Dough,68705751,32989,7181,25808,2022-04-20
3985,Google Inc.,Brand Publicity,Space Wars,35341376,32951,4655,28296,2022-07-30
4119,KYG Antler LLC,Media Supported Asset,Merf,21727830,32908,220,32688,2022-01-29
3538,The Martingale Agency,Media Supported Asset,Merf,70703055,32892,13932,18960,2022-05-26
4550,Pinterest Inc,Brand Publicity,Space Wars,47474016,32888,6797,26091,2022-07-08
1484,KYG Antler LLC,Influencer,Merf,67312076,32838,4533,28305,2022-01-25
375,Nintendo Technologies,E-Commerce,Clay-Dough,88047203,32785,2317,30468,2022-09-14
3695,Nintendo Technologies,Brand Publicity,GI-Bro,73081146,32751,23570,9181,2022-06-11
196,KYG Antler LLC,E-Commerce,Merf,75652849,32719,7669,25050,2022-08-11
43,Google Inc.,Influencer,Merf,92618046,32718,4368,28350,2022-06-27
4561,Pinterest Inc,Influencer,Merf,30045516,32673,3646,29027,2022-02-11
4808,Nintendo Technologies,Influencer,Merf,81934499,32504,7297,25207,2022-08-15
2703,Disney Studios,Media Supported Asset,Clay-Dough,35840847,32416,2497,29919,2022-09-02
1079,Pinterest Inc,Influencer,Transmorphers,17307558,32330,5878,26452,2022-01-30
4758,Nintendo Technologies,Brand Asset Development,Space Wars,21038319,32288,24494,7794,2022-01-22
1384,Meta Platforms,Brand Asset Development,Clay-Dough,25277771,32262,9412,22850,2022-04-09
3808,Google Inc.,Media Supported Asset,GI-Bro,40714509,32234,14760,17474,2022-04-07
2874,The Martingale Agency,E-Commerce,Merf,18073520,32209,6614,25595,2022-04-23
3810,Pinterest Inc,Brand Publicity,Transmorphers,99519216,32199,10764,21435,2022-06-28
1487,Google Inc.,Brand Asset Development,Space Wars,40573371,32192,5156,27036,2022-09-10
1535,Nintendo Technologies,Brand Publicity,GI-Bro,27934229,32140,4159,27981,2022-09-10
466,KYG Antler LLC,E-Commerce,Space Wars,21725753,32124,22149,9975,2022-04-28
3020,Google Inc.,Brand Publicity,GI-Bro,97133356,32115,257,31858,2022-08-23
2768,TikTok Inc,Media Supported Asset,Merf,53601303,32054,21229,10825,2022-06-07
656,TikTok Inc,Brand Asset Development,Clay-Dough,92670660,32045,4858,27187,2022-08-31
742,KYG Antler LLC,Media Supported Asset,Space Wars,47082446,32034,1673,30361,2022-03-06
3021,Meta Platforms,E-Commerce,Clay-Dough,15742721,32027,447,31580,2022-07-09
3337,Disney Studios,Influencer,Clay-Dough,90036744,32002,5991,26011,2022-05-07
2661,Meta Platforms,E-Commerce,Transmorphers,79502120,31953,19174,12779,2022-01-27
4045,KYG Antler LLC,Brand Asset Development,Merf,59858913,31952,16410,15542,2022-02-15
2919,TikTok Inc,E-Commerce,Space Wars,11158594,31942,2054,29888,2022-01-15
3308,Disney Studios,Influencer,GI-Bro,30048872,31898,2648,29250,2022-02-18
3737,KYG Antler LLC,Brand Publicity,Clay-Dough,86197721,31846,812,31034,2022-08-24
4783,Meta Platforms,Influencer,GI-Bro,88535992,31812,21286,10526,2022-05-13
2277,Meta Platforms,Media Supported Asset,Space Wars,15010579,31784,1006,30778,2022-09-06
4212,Pinterest Inc,Media Supported Asset,Space Wars,44746185,31758,13784,17974,2022-03-16
2082,KYG Antler LLC,Influencer,GI-Bro,17068079,31748,2239,29509,2022-01-24
4358,Google Inc.,Influencer,Merf,73688057,31708,5004,26704,2022-07-01
1989,Meta Platforms,Influencer,Space Wars,24046071,31704,6229,25475,2022-09-02
4394,TikTok Inc,E-Commerce,Clay-Dough,76671595,31653,26339,5314,2022-03-28
3648,The Martingale Agency,Media Supported Asset,GI-Bro,11528140,31629,11087,20542,2022-04-05
4337,TikTok Inc,Brand Publicity,Merf,27949248,31620,18475,13145,2022-06-24
2401,Google Inc.,Media Supported Asset,Clay-Dough,95894489,31592,948,30644,2022-07-26
3366,The Martingale Agency,E-Commerce,Space Wars,98873615,31589,12453,19136,2022-02-20
3872,TikTok Inc,Brand Publicity,Transmorphers,84925625,31581,4444,27137,2022-08-22
4730,Meta Platforms,Brand Asset Development,GI-Bro,90237007,31579,29796,1783,2022-06-24
4517,Pinterest Inc,Influencer,Space Wars,33049887,31536,10998,20538,2022-01-31
4064,TikTok Inc,Brand Publicity,GI-Bro,48538756,31524,12929,18595,2022-06-19
2059,Google Inc.,Brand Publicity,GI-Bro,73175715,31378,11505,19873,2022-05-14
4600,Meta Platforms,E-Commerce,Transmorphers,70549718,31344,2715,28629,2022-09-20
426,The Martingale Agency,Brand Asset Development,Merf,91299489,31294,13653,17641,2022-01-16
842,Meta Platforms,Influencer,Merf,99248348,31291,18797,12494,2022-04-09
456,Meta Platforms,E-Commerce,Merf,77546149,31281,24559,6722,2022-06-03
1022,Nintendo Technologies,Brand Publicity,Clay-Dough,27849076,31230,1806,29424,2022-06-18
3937,The Martingale Agency,Brand Publicity,Clay-Dough,30295285,31194,24301,6893,2022-02-25
4089,Google Inc.,E-Commerce,Transmorphers,70452293,31178,13681,17497,2022-05-06
242,Pinterest Inc,Influencer,Transmorphers,48096022,31082,7920,23162,2022-01-23
4210,Pinterest Inc,Influencer,GI-Bro,28230597,31082,1959,29123,2022-08-29
3834,Disney Studios,Brand Asset Development,Space Wars,72932415,31077,12379,18698,2022-01-24
5,Meta Platforms,Brand Asset Development,Clay-Dough,23497854,31074,3623,27451,2022-01-22
1887,Meta Platforms,Influencer,Transmorphers,79044458,31022,3617,27405,2022-07-18
3223,Disney Studios,E-Commerce,Space Wars,78846501,31021,4135,26886,2022-05-17
2967,The Martingale Agency,E-Commerce,GI-Bro,26517368,30998,3523,27475,2022-07-29
4851,TikTok Inc,Brand Asset Development,Transmorphers,95667380,30974,29483,1491,2022-02-12
4740,Disney Studios,E-Commerce,Transmorphers,15960199,30957,3951,27006,2022-08-11
1255,Google Inc.,Media Supported Asset,Merf,62357150,30924,10210,20714,2022-03-30
570,Pinterest Inc,Brand Asset Development,Space Wars,36452005,30908,29165,1743,2022-06-04
4780,Pinterest Inc,Media Supported Asset,GI-Bro,95781271,30888,5645,25243,2022-09-01
292,KYG Antler LLC,E-Commerce,Clay-Dough,73231691,30878,19177,11701,2022-03-31
581,Disney Studios,Influencer,Clay-Dough,42681889,30858,29905,953,2022-03-02
4359,Nintendo Technologies,Media Supported Asset,Clay-Dough,99991338,30832,2737,28095,2022-08-03
3788,KYG Antler LLC,E-Commerce,Merf,41697107,30827,2383,28444,2022-08-15
3251,Disney Studios,E-Commerce,Space Wars,61986617,30821,27719,3102,2022-01-09
4762,The Martingale Agency,Brand Publicity,Transmorphers,94562813,30781,871,29910,2022-03-12
1172,Disney Studios,E-Commerce,Transmorphers,15865526,30779,3207,27572,2022-08-11
4792,Nintendo Technologies,E-Commerce,Transmorphers,72684805,30744,277,30467,2022-08-28
4838,Meta Platforms,Media Supported Asset,GI-Bro,72873566,30733,2968,27765,2022-09-21
450,Disney Studios,Brand Publicity,Transmorphers,33564796,30729,13677,17052,2022-02-19
924,TikTok Inc,Influencer,GI-Bro,41563653,30701,1645,29056,2022-07-22
985,KYG Antler LLC,Media Supported Asset,GI-Bro,27902105,30669,5055,25614,2022-06-09
3568,Disney Studios,Influencer,Space Wars,83260441,30646,5136,25510,2022-09-20
1611,Disney Studios,Influencer,Clay-Dough,50954671,30619,2246,28373,2022-07-14
4571,The Martingale Agency,Brand Publicity,GI-Bro,66559261,30612,385,30227,2022-08-11
995,TikTok Inc,Influencer,Transmorphers,90544769,30604,3551,27053,2022-08-15
4306,The Martingale Agency,Media Supported Asset,Merf,16562641,30600,3977,26623,2022-03-27
4095,Nintendo Technologies,Brand Publicity,Space Wars,65897217,30543,2328,28215,2022-02-23
2584,The Martingale Agency,Brand Asset Development,Merf,10623000,30512,29866,646,2022-01-11
1169,Meta Platforms,Media Supported Asset,GI-Bro,92908022,30509,14240,16269,2022-02-26
655,KYG Antler LLC,Brand Publicity,Clay-Dough,73877617,30502,22632,7870,2022-03-02
3724,Meta Platforms,E-Commerce,GI-Bro,36080740,30496,6915,23581,2022-01-17
1176,Nintendo Technologies,E-Commerce,Space Wars,88813152,30493,4685,25808,2022-02-23
1882,The Martingale Agency,Brand Asset Development,Clay-Dough,17516561,30479,2082,28397,2022-09-15
1271,Pinterest Inc,Brand Publicity,GI-Bro,15054523,30467,16041,14426,2022-04-29
3795,TikTok Inc,Influencer,Clay-Dough,49461185,30460,2265,28195,2022-08-30
1721,TikTok Inc,Influencer,GI-Bro,85155990,30420,21867,8553,2022-05-31
582,Disney Studios,Influencer,Space Wars,94170513,30397,3230,27167,2022-08-10
1201,KYG Antler LLC,E-Commerce,Transmorphers,41895063,30360,28587,1773,2022-06-18
4729,TikTok Inc,Brand Publicity,Transmorphers,97333655,30351,250,30101,2022-08-24
1428,Google Inc.,E-Commerce,Merf,99359677,30337,27851,2486,2022-04-07
4399,Pinterest Inc,Brand Publicity,Clay-Dough,20426838,30304,28167,2137,2022-01-19
3948,KYG Antler LLC,Influencer,Clay-Dough,48999229,30282,20554,9728,2022-05-18
244,The Martingale Agency,Influencer,GI-Bro,67041302,30250,2827,27423,2022-09-25
2965,TikTok Inc,E-Commerce,Merf,88808447,30236,5505,24731,2022-01-27
95,The Martingale Agency,Media Supported Asset,Transmorphers,13941348,30232,953,29279,2022-07-08
3010,Meta Platforms,E-Commerce,Space Wars,85486043,30216,8573,21643,2022-04-13
1745,Meta Platforms,Brand Asset Development,GI-Bro,54008841,30197,18319,11878,2022-02-13
3764,Nintendo Technologies,Brand Asset Development,GI-Bro,86667226,30149,26494,3655,2022-01-03
3274,Pinterest Inc,E-Commerce,Merf,32964242,30146,16114,14032,2022-06-26
2057,Google Inc.,Brand Asset Development,Space Wars,39728118,30144,4351,25793,2022-07-12
2894,Meta Platforms,Influencer,Clay-Dough,58551281,30125,22129,7996,2022-03-27
2183,Disney Studios,Influencer,Space Wars,58996527,30104,1530,28574,2022-01-16
2404,TikTok Inc,Media Supported Asset,GI-Bro,59887705,30093,2873,27220,2022-05-09
2488,Nintendo Technologies,Influencer,Clay-Dough,10552930,30027,24986,5041,2022-06-23
47,KYG Antler LLC,Influencer,Space Wars,64567440,30026,20034,9992,2022-04-12
4044,Disney Studios,Influencer,Space Wars,37468509,30013,3337,26676,2022-06-03
2184,Meta Platforms,Brand Asset Development,Space Wars,91936550,29934,2478,27456,2022-02-24
3426,Disney Studios,E-Commerce,Clay-Dough,90578985,29904,9670,20234,2022-05-30
1289,Google Inc.,Brand Asset Development,Merf,67859423,29896,24162,5734,2022-06-14
1785,Google Inc.,Brand Publicity,Clay-Dough,32904492,29879,28320,1559,2022-04-05
1390,Disney Studios,Brand Publicity,Space Wars,57809754,29859,1069,28790,2022-08-06
1463,Disney Studios,E-Commerce,GI-Bro,90418936,29823,8560,21263,2022-06-09
4021,Nintendo Technologies,E-Commerce,Merf,52639432,29802,7214,22588,2022-05-15
2615,KYG Antler LLC,E-Commerce,GI-Bro,61292072,29799,12879,16920,2022-02-19
2472,Google Inc.,E-Commerce,Clay-Dough,53335553,29786,1675,28111,2022-08-30
3927,Meta Platforms,Media Supported Asset,Clay-Dough,36977737,29722,22255,7467,2022-02-09
3770,Google Inc.,Media Supported Asset,Merf,79004827,29693,3961,25732,2022-06-17
363,Meta Platforms,Media Supported Asset,Transmorphers,89106097,29669,648,29021,2022-09-12
448,Disney Studios,Brand Asset Development,GI-Bro,85555057,29649,10345,19304,2022-03-22
4063,The Martingale Agency,Brand Asset Development,Merf,32957104,29625,16503,13122,2022-03-14
4610,TikTok Inc,Brand Asset Development,Transmorphers,16387482,29625,19971,9654,2022-02-21
3121,Pinterest Inc,Influencer,Clay-Dough,27044449,29612,10895,18717,2022-04-03
155,Disney Studios,E-Commerce,Merf,70920529,29604,913,28691,2022-07-03
3405,KYG Antler LLC,Media Supported Asset,GI-Bro,68484471,29582,4071,25511,2022-09-14
1419,TikTok Inc,Media Supported Asset,Merf,19657696,29544,5742,23802,2022-06-09
1226,TikTok Inc,Media Supported Asset,Space Wars,51156723,29495,17178,12317,2022-05-18
1340,Nintendo Technologies,Brand Asset Development,Clay-Dough,91020568,29474,10765,18709,2022-06-24
4500,Pinterest Inc,Brand Asset Development,Transmorphers,93819973,29473,12067,17406,2022-06-07
3936,Meta Platforms,Brand Publicity,Clay-Dough,18104354,29463,3031,26432,2022-04-15
3120,Pinterest Inc,Media Supported Asset,Clay-Dough,37241010,29450,3966,25484,2022-03-29
4270,Google Inc.,Media Supported Asset,Merf,25307673,29436,6328,23108,2022-05-02
3346,Google Inc.,Brand Asset Development,GI-Bro,54495039,29429,10929,18500,2022-03-14
2949,The Martingale Agency,Brand Asset Development,Transmorphers,42964850,29422,14680,14742,2022-06-16
4020,Nintendo Technologies,Influencer,Clay-Dough,22479432,29402,27416,1986,2022-01-05
3849,TikTok Inc,Brand Publicity,Merf,62828642,29333,2049,27284,2022-01-26
3668,Meta Platforms,Brand Publicity,GI-Bro,64618106,29319,26157,3162,2022-01-04
763,KYG Antler LLC,Brand Asset Development,Merf,93897659,29302,2458,26844,2022-09-12
2317,Meta Platforms,Brand Publicity,GI-Bro,15602409,29207,19735,9472,2022-04-11
262,Google Inc.,Brand Publicity,GI-Bro,62112147,29206,7948,21258,2022-01-22
1298,TikTok Inc,Media Supported Asset,Clay-Dough,25234584,29192,1246,27946,2022-06-03
1152,Google Inc.,Influencer,Space Wars,42584368,29159,8771,20388,2022-06-13
957,Disney Studios,Brand Asset Development,Merf,44901468,29156,4490,24666,2022-06-23
2351,The Martingale Agency,E-Commerce,Space Wars,41704513,29138,8520,20618,2022-03-28
1246,Nintendo Technologies,Influencer,GI-Bro,74719550,29111,3559,25552,2022-08-22
1089,Google Inc.,Brand Publicity,Space Wars,29055202,29037,3696,25341,2022-08-16
2853,Disney Studios,Influencer,Merf,53178964,29027,10493,18534,2022-05-22
1851,Disney Studios,Influencer,Clay-Dough,42860230,29023,1035,27988,2022-09-25
1961,Pinterest Inc,Media Supported Asset,Space Wars,89483421,28980,1860,27120,2022-07-19
1192,KYG Antler LLC,E-Commerce,Space Wars,89463234,28977,3152,25825,2022-09-13
3351,KYG Antler LLC,E-Commerce,GI-Bro,69603715,28946,26548,2398,2022-02-19
820,Nintendo Technologies,E-Commerce,Space Wars,75487645,28942,657,28285,2022-09-26
2961,Meta Platforms,Brand Asset Development,Clay-Dough,52435437,28930,2078,26852,2022-09-11
1478,KYG Antler LLC,Brand Publicity,Merf,63014962,28895,3958,24937,2022-05-11
2964,Meta Platforms,E-Commerce,Transmorphers,30911492,28872,24344,4528,2022-03-27
2781,Meta Platforms,Influencer,Space Wars,83572695,28864,19774,9090,2022-05-02
3195,Google Inc.,Media Supported Asset,GI-Bro,62143021,28811,25345,3466,2022-01-16
480,Disney Studios,Brand Asset Development,GI-Bro,13543803,28810,2451,26359,2022-07-22
1884,Nintendo Technologies,Media Supported Asset,Space Wars,61226931,28786,3366,25420,2022-07-21
4652,Meta Platforms,Brand Asset Development,Clay-Dough,42549905,28764,1592,27172,2022-08-16
2786,Disney Studios,Media Supported Asset,Clay-Dough,52845654,28737,14749,13988,2022-05-26
1753,TikTok Inc,Influencer,GI-Bro,66478242,28684,4486,24198,2022-01-27
4813,Nintendo Technologies,Media Supported Asset,Transmorphers,27934416,28609,118,28491,2022-07-07
2673,Disney Studios,E-Commerce,Transmorphers,86438539,28602,9037,19565,2022-05-19
2694,KYG Antler LLC,Brand Publicity,Transmorphers,22903829,28597,20908,7689,2022-04-02
4793,KYG Antler LLC,Brand Asset Development,GI-Bro,13853570,28554,9664,18890,2022-01-28
3831,Meta Platforms,Brand Publicity,Merf,85173850,28526,1692,26834,2022-02-11
418,Meta Platforms,Influencer,Space Wars,19115651,28509,966,27543,2022-07-06
4154,TikTok Inc,Influencer,Transmorphers,18555232,28497,3090,25407,2022-07-01
413,Disney Studios,Media Supported Asset,Transmorphers,18633373,28456,1202,27254,2022-03-13
4003,TikTok Inc,Brand Publicity,GI-Bro,25542652,28410,3227,25183,2022-07-21
3507,The Martingale Agency,E-Commerce,Transmorphers,74915720,28397,14969,13428,2022-05-20
2563,Nintendo Technologies,E-Commerce,Merf,28264811,28357,27276,1081,2022-04-27
3630,Meta Platforms,Influencer,Space Wars,48419368,28278,16306,11972,2022-02-02
2605,The Martingale Agency,Influencer,Transmorphers,50503417,28260,6199,22061,2022-04-05
184,The Martingale Agency,Brand Publicity,Space Wars,33732788,28207,4972,23235,2022-06-26
79,Disney Studios,Influencer,Merf,63861721,28169,16761,11408,2022-02-21
4098,KYG Antler LLC,Brand Publicity,Clay-Dough,77493526,28158,16364,11794,2022-06-04
3874,Google Inc.,Brand Asset Development,Merf,85792516,28153,1704,26449,2022-08-22
1646,TikTok Inc,Brand Asset Development,Space Wars,98575084,28131,2940,25191,2022-09-15
2968,Pinterest Inc,Media Supported Asset,Clay-Dough,40950401,28130,14759,13371,2022-06-14
3910,TikTok Inc,Influencer,Merf,66283596,28057,9097,18960,2022-04-30
4710,Meta Platforms,Brand Publicity,Merf,37069274,28039,3936,24103,2022-05-25
143,Meta Platforms,E-Commerce,Merf,97453874,28032,14607,13425,2022-04-02
3279,Nintendo Technologies,Influencer,Clay-Dough,37570544,27929,9239,18690,2022-04-19
397,Nintendo Technologies,Media Supported Asset,Space Wars,80782039,27921,13698,14223,2022-06-11
4435,The Martingale Agency,Influencer,Transmorphers,20204880,27908,21201,6707,2022-05-19
1493,TikTok Inc,Media Supported Asset,GI-Bro,31784226,27898,1310,26588,2022-08-31
2441,Disney Studios,Brand Publicity,Clay-Dough,90502991,27863,14702,13161,2022-03-28
4683,Meta Platforms,Media Supported Asset,GI-Bro,38225862,27835,2113,25722,2022-08-15
769,KYG Antler LLC,E-Commerce,Clay-Dough,99144399,27793,822,26971,2022-08-02
27,TikTok Inc,Media Supported Asset,Clay-Dough,25626638,27783,21239,6544,2022-01-31
2467,Pinterest Inc,Media Supported Asset,Space Wars,11046027,27743,21976,5767,2022-02-07
1522,Google Inc.,E-Commerce,GI-Bro,64572311,27712,1636,26076,2022-07-27
3186,Pinterest Inc,Brand Asset Development,Clay-Dough,30939735,27688,3215,24473,2022-03-12
4148,The Martingale Agency,E-Commerce,Clay-Dough,23673645,27677,19209,8468,2022-05-03
55,Disney Studios,Media Supported Asset,Clay-Dough,18914432,27648,22267,5381,2022-05-16
2539,Meta Platforms,E-Commerce,Clay-Dough,38731538,27633,7255,20378,2022-01-18
1031,Google Inc.,E-Commerce,Space Wars,80205725,27572,26984,588,2022-01-26
2692,Meta Platforms,Brand Asset Development,GI-Bro,14666626,27556,322,27234,2022-05-20
1178,TikTok Inc,E-Commerce,Clay-Dough,91075013,27487,2216,25271,2022-08-23
4352,Google Inc.,Influencer,GI-Bro,81729510,27466,20162,7304,2022-02-08
4644,Nintendo Technologies,Influencer,Clay-Dough,20322342,27414,1544,25870,2022-08-31
2752,Disney Studios,Influencer,Clay-Dough,60653955,27302,17990,9312,2022-01-31
2158,TikTok Inc,Brand Publicity,Transmorphers,95169124,27262,8520,18742,2022-06-29
1626,KYG Antler LLC,E-Commerce,Space Wars,54826867,27251,16577,10674,2022-06-01
4890,Google Inc.,Brand Asset Development,Transmorphers,96187999,27199,19272,7927,2022-03-30
566,The Martingale Agency,Influencer,Transmorphers,85473447,27177,17243,9934,2022-03-21
445,Google Inc.,Influencer,Clay-Dough,72537313,27155,26044,1111,2022-02-14
4410,Pinterest Inc,Brand Publicity,Space Wars,99664514,27146,22753,4393,2022-04-27
440,Disney Studios,Influencer,Transmorphers,57505760,27140,5029,22111,2022-04-06
929,TikTok Inc,Media Supported Asset,Clay-Dough,15414965,27119,260,26859,2022-09-14
4221,Google Inc.,Media Supported Asset,Transmorphers,86684912,27114,3121,23993,2022-05-15
1395,Meta Platforms,Brand Publicity,GI-Bro,88563273,27106,26911,195,2022-02-27
17,Google Inc.,Media Supported Asset,Space Wars,32142803,27043,24051,2992,2022-02-14
171,Meta Platforms,Brand Publicity,Merf,75615744,27040,593,26447,2022-08-23
215,Meta Platforms,E-Commerce,Merf,37730617,27030,16689,10341,2022-01-14
1296,Disney Studios,Influencer,Merf,39378290,27008,14026,12982,2022-03-07
408,Google Inc.,Media Supported Asset,Transmorphers,47684997,26998,17479,9519,2022-01-27
2538,Disney Studios,Media Supported Asset,Merf,31144569,26982,15781,11201,2022-05-17
881,The Martingale Agency,Brand Asset Development,Merf,32580507,26975,14780,12195,2022-06-06
4579,The Martingale Agency,Brand Asset Development,Space Wars,92448820,26934,22710,4224,2022-04-11
3376,TikTok Inc,Brand Publicity,Space Wars,37594907,26918,20012,6906,2022-04-11
2879,Disney Studios,Media Supported Asset,Merf,31839550,26865,300,26565,2022-07-28
4967,Disney Studios,E-Commerce,Transmorphers,79627257,26824,13954,12870,2022-01-08
3289,Disney Studios,Brand Publicity,GI-Bro,89584689,26796,8713,18083,2022-02-27
3160,Disney Studios,Influencer,Clay-Dough,86207817,26782,12946,13836,2022-04-03
1146,Google Inc.,Influencer,Space Wars,26233299,26766,1670,25096,2022-09-22
3415,KYG Antler LLC,Influencer,GI-Bro,98918264,26740,19196,7544,2022-03-17
3614,Disney Studios,Brand Asset Development,Transmorphers,23270132,26682,1137,25545,2022-07-31
3182,KYG Antler LLC,Brand Publicity,Merf,16238131,26672,1132,25540,2022-09-08
750,Pinterest Inc,Influencer,Transmorphers,39139335,26639,2217,24422,2022-03-17
2721,TikTok Inc,Media Supported Asset,GI-Bro,52682390,26633,9579,17054,2022-04-21
3363,Google Inc.,Brand Asset Development,GI-Bro,20043871,26550,11039,15511,2022-01-30
1889,The Martingale Agency,Brand Publicity,Transmorphers,93947404,26527,25495,1032,2022-04-11
337,Pinterest Inc,Brand Asset Development,Transmorphers,39162258,26521,9546,16975,2022-01-27
231,KYG Antler LLC,Influencer,Merf,87670146,26484,2292,24192,2022-04-08
1676,Google Inc.,E-Commerce,Merf,45656956,26455,257,26198,2022-08-20
3713,Disney Studios,Influencer,GI-Bro,34787084,26445,10880,15565,2022-04-13
4685,Google Inc.,Influencer,Merf,44469838,26442,7655,18787,2022-01-25
1972,Nintendo Technologies,Brand Asset Development,Clay-Dough,11284080,26438,25261,1177,2022-03-12
2287,Nintendo Technologies,Media Supported Asset,Merf,73070307,26433,1669,24764,2022-02-09
1720,Meta Platforms,Brand Asset Development,Merf,34075487,26426,738,25688,2022-07-15
1978,Google Inc.,Brand Publicity,Clay-Dough,95285622,26397,560,25837,2022-07-25
740,Pinterest Inc,Brand Publicity,Transmorphers,35795319,26392,824,25568,2022-07-15
3727,Google Inc.,E-Commerce,Clay-Dough,11839457,26365,664,25701,2022-08-10
3088,The Martingale Agency,Influencer,Transmorphers,50416166,26361,1025,25336,2022-08-06
4175,KYG Antler LLC,Brand Publicity,Transmorphers,61369921,26360,24199,2161,2022-02-03
3375,Nintendo Technologies,Influencer,GI-Bro,52303765,26283,7661,18622,2022-03-06
4019,Nintendo Technologies,E-Commerce,Merf,52087241,26258,271,25987,2022-07-12
4460,Disney Studios,Influencer,Clay-Dough,85200254,26166,241,25925,2022-09-26
3556,TikTok Inc,Brand Asset Development,Transmorphers,85937405,26116,968,25148,2022-08-15
13,Nintendo Technologies,Brand Asset Development,GI-Bro,17901608,26097,19961,6136,2022-01-27
2793,Google Inc.,E-Commerce,Space Wars,38645645,26089,544,25545,2022-09-01
2033,Nintendo Technologies,Media Supported Asset,Clay-Dough,99613052,26079,775,25304,2022-07-30
2554,Meta Platforms,Brand Asset Development,GI-Bro,91729682,26068,16591,9477,2022-06-19
109,KYG Antler LLC,E-Commerce,Space Wars,94598231,26026,25261,765,2022-01-08
3944,Meta Platforms,E-Commerce,GI-Bro,18222513,26007,19705,6302,2022-01-23
255,Google Inc.,Influencer,GI-Bro,52066570,25990,11312,14678,2022-03-20
4811,Disney Studios,Influencer,GI-Bro,37660433,25965,513,25452,2022-06-13
4548,Google Inc.,Brand Asset Development,Transmorphers,43952162,25926,898,25028,2022-08-25
4716,KYG Antler LLC,Influencer,Clay-Dough,56867195,25899,136,25763,2022-08-24
3961,Disney Studios,Brand Publicity,GI-Bro,80855270,25893,13190,12703,2022-01-04
2533,KYG Antler LLC,Brand Asset Development,Clay-Dough,49960837,25885,784,25101,2022-07-09
2619,Nintendo Technologies,Influencer,Clay-Dough,65874396,25842,302,25540,2022-07-12
46,The Martingale Agency,E-Commerce,Merf,25886582,25816,6071,19745,2022-05-27
1822,Disney Studios,Brand Asset Development,Merf,70991401,25781,2970,22811,2022-06-02
1801,TikTok Inc,Influencer,Transmorphers,42682567,25779,18458,7321,2022-06-23
2425,KYG Antler LLC,Influencer,Transmorphers,80276472,25770,16125,9645,2022-05-29
2324,Google Inc.,Influencer,Clay-Dough,95239401,25737,91,25646,2022-07-18
2048,Pinterest Inc,Brand Publicity,Merf,75099740,25735,2533,23202,2022-02-15
2769,Meta Platforms,Brand Asset Development,GI-Bro,93935778,25638,12360,13278,2022-04-09
4925,Meta Platforms,Brand Publicity,Merf,18021921,25596,20639,4957,2022-05-15
510,TikTok Inc,Brand Asset Development,Transmorphers,57589433,25540,7533,18007,2022-02-12
2015,Google Inc.,Influencer,Transmorphers,52392204,25486,2168,23318,2022-03-12
1465,Google Inc.,E-Commerce,Transmorphers,94822027,25459,25115,344,2022-06-15
4949,Pinterest Inc,Media Supported Asset,Space Wars,94193313,25459,8636,16823,2022-05-21
2830,TikTok Inc,Media Supported Asset,Space Wars,34076293,25449,12894,12555,2022-04-01
1804,KYG Antler LLC,Brand Publicity,Merf,11765003,25444,22615,2829,2022-01-10
4520,KYG Antler LLC,Brand Asset Development,Transmorphers,59876176,25438,3202,22236,2022-03-07
1189,The Martingale Agency,E-Commerce,Merf,60092323,25429,15787,9642,2022-01-12
1984,TikTok Inc,Brand Asset Development,Clay-Dough,28771229,25401,13907,11494,2022-01-26
2241,Pinterest Inc,Brand Asset Development,Clay-Dough,23853078,25345,285,25060,2022-07-04
3034,Disney Studios,Media Supported Asset,Merf,67546547,25316,206,25110,2022-08-17
1736,Pinterest Inc,Media Supported Asset,GI-Bro,94234369,25313,8700,16613,2022-04-13
4047,Pinterest Inc,Brand Asset Development,Merf,52129758,25292,21173,4119,2022-02-16
1431,Pinterest Inc,Brand Publicity,Merf,76989243,25284,141,25143,2022-08-11
1344,The Martingale Agency,Brand Asset Development,Clay-Dough,53081702,25252,15848,9404,2022-06-10
3249,Google Inc.,Brand Asset Development,Merf,25221638,25245,2010,23235,2022-03-14
3827,The Martingale Agency,Influencer,GI-Bro,96091901,25217,179,25038,2022-09-08
4484,Meta Platforms,E-Commerce,Transmorphers,37597858,25215,121,25094,2022-08-30
1991,The Martingale Agency,E-Commerce,Transmorphers,66717770,25212,1819,23393,2022-06-11
3509,Disney Studios,Influencer,Space Wars,54587445,25195,3426,21769,2022-01-18
2068,Disney Studios,Influencer,Space Wars,48988826,25174,15661,9513,2022-04-21
2942,Google Inc.,Brand Asset Development,Clay-Dough,35522942,25154,18738,6416,2022-06-13
3402,Disney Studios,Media Supported Asset,Transmorphers,32386578,25090,4135,20955,2022-02-28
523,Disney Studios,Brand Publicity,Merf,76247270,25086,19237,5849,2022-02-08
1717,Pinterest Inc,Brand Asset Development,Clay-Dough,98186686,25045,11537,13508,2022-02-14
4617,KYG Antler LLC,Brand Asset Development,Clay-Dough,32211525,25031,11998,13033,2022-04-27
3492,Google Inc.,Influencer,Transmorphers,33976780,25014,3101,21913,2022-03-21
3393,The Martingale Agency,Influencer,Merf,57753159,24977,1071,23906,2022-01-17
4521,TikTok Inc,Brand Publicity,Transmorphers,66713100,24963,16775,8188,2022-04-19
1420,The Martingale Agency,E-Commerce,Transmorphers,83778815,24919,18594,6325,2022-03-28
3499,Meta Platforms,Brand Publicity,Transmorphers,42530319,24857,19755,5102,2022-04-22
178,Pinterest Inc,E-Commerce,GI-Bro,70865965,24834,3810,21024,2022-04-23
433,Google Inc.,Media Supported Asset,GI-Bro,86317508,24779,18895,5884,2022-06-28
589,Disney Studios,Brand Publicity,Space Wars,99727335,24771,23469,1302,2022-03-18
221,Disney Studios,Influencer,Merf,73752087,24729,13525,11204,2022-04-01
3864,Meta Platforms,Media Supported Asset,Transmorphers,22680557,24670,19351,5319,2022-02-06
357,Google Inc.,Media Supported Asset,GI-Bro,99416615,24661,20345,4316,2022-01-18
2418,Nintendo Technologies,Brand Asset Development,GI-Bro,79088673,24647,11839,12808,2022-01-10
1806,KYG Antler LLC,Media Supported Asset,Space Wars,52894738,24612,11211,13401,2022-03-24
3196,Google Inc.,E-Commerce,Merf,40525428,24521,11199,13322,2022-04-28
4951,Nintendo Technologies,Brand Asset Development,GI-Bro,68268276,24516,18491,6025,2022-03-22
1975,The Martingale Agency,Media Supported Asset,Transmorphers,73366022,24478,20673,3805,2022-06-04
607,The Martingale Agency,Brand Asset Development,Space Wars,73200404,24413,10372,14041,2022-04-16
935,Meta Platforms,E-Commerce,Merf,60630585,24400,8630,15770,2022-06-11
1652,Disney Studios,Brand Publicity,Space Wars,12791861,24304,13315,10989,2022-01-27
2321,Nintendo Technologies,Media Supported Asset,Clay-Dough,65361169,24288,6189,18099,2022-01-24
437,Disney Studios,Media Supported Asset,Merf,66064974,24278,17504,6774,2022-05-15
2462,The Martingale Agency,Influencer,Transmorphers,20634710,24256,19306,4950,2022-02-03
4902,Meta Platforms,E-Commerce,Merf,63069140,24251,3945,20306,2022-06-30
1365,TikTok Inc,E-Commerce,Space Wars,55251325,24212,6969,17243,2022-04-13
2662,The Martingale Agency,E-Commerce,Transmorphers,35967126,24161,22991,1170,2022-02-08
2225,Disney Studios,Brand Publicity,Merf,53216473,24127,19238,4889,2022-04-06
4461,KYG Antler LLC,Brand Publicity,Clay-Dough,29297582,24096,2200,21896,2022-05-26
2887,Meta Platforms,E-Commerce,Clay-Dough,15689942,24068,15180,8888,2022-03-04
2222,Google Inc.,Media Supported Asset,Clay-Dough,76549555,24064,22182,1882,2022-06-05
904,TikTok Inc,Influencer,Merf,85720139,24010,9325,14685,2022-01-04
324,Nintendo Technologies,Media Supported Asset,Space Wars,45260078,24008,10659,13349,2022-04-03
4239,Disney Studios,E-Commerce,GI-Bro,66329996,24002,8990,15012,2022-01-26
2365,Disney Studios,Brand Publicity,Clay-Dough,46939900,23919,5947,17972,2022-05-15
3458,KYG Antler LLC,Media Supported Asset,Clay-Dough,30946745,23838,10819,13019,2022-03-17
496,TikTok Inc,Influencer,Clay-Dough,64481521,23759,21972,1787,2022-04-04
3575,Nintendo Technologies,Brand Publicity,Merf,17697257,23655,19530,4125,2022-06-16
1728,Disney Studios,Influencer,Transmorphers,73239191,23638,13947,9691,2022-05-13
1326,Pinterest Inc,E-Commerce,Merf,83372600,23614,19399,4215,2022-05-20
3890,TikTok Inc,Brand Asset Development,Space Wars,23681214,23608,23599,9,2022-01-24
4897,The Martingale Agency,Brand Asset Development,Space Wars,75923753,23544,13941,9603,2022-05-06
2628,The Martingale Agency,Media Supported Asset,GI-Bro,54736012,23534,251,23283,2022-03-20
3954,TikTok Inc,Brand Publicity,Transmorphers,83470231,23534,6171,17363,2022-03-19
3844,Disney Studios,Influencer,Clay-Dough,71290607,23513,7361,16152,2022-04-19
1397,KYG Antler LLC,Influencer,Clay-Dough,64092655,23497,17808,5689,2022-02-20
2737,Pinterest Inc,Brand Asset Development,GI-Bro,70360373,23372,12992,10380,2022-04-24
2501,KYG Antler LLC,Brand Publicity,GI-Bro,16984054,23272,20546,2726,2022-03-18
2474,Nintendo Technologies,Media Supported Asset,Clay-Dough,93432783,23141,12604,10537,2022-02-27
4964,The Martingale Agency,Media Supported Asset,Transmorphers,93585621,23113,7443,15670,2022-02-17
2500,Nintendo Technologies,E-Commerce,Merf,80163476,23054,8813,14241,2022-03-26
3448,Google Inc.,Influencer,Transmorphers,21941984,23049,8957,14092,2022-06-26
3835,KYG Antler LLC,Influencer,Transmorphers,30205551,23005,591,22414,2022-02-17
1551,Nintendo Technologies,E-Commerce,Clay-Dough,75944809,22993,22493,500,2022-04-01
1874,KYG Antler LLC,E-Commerce,Merf,43732258,22986,3016,19970,2022-06-29
4323,The Martingale Agency,Brand Asset Development,Space Wars,15041484,22985,11485,11500,2022-02-25
3181,Meta Platforms,Brand Asset Development,Transmorphers,64514291,22978,6535,16443,2022-05-19
2877,Google Inc.,Brand Publicity,GI-Bro,36163412,22941,11909,11032,2022-02-04
1914,Google Inc.,Brand Asset Development,Merf,22236338,22898,12436,10462,2022-04-07
4666,Google Inc.,Brand Publicity,Space Wars,66544763,22812,21529,1283,2022-06-28
2915,KYG Antler LLC,Brand Asset Development,Transmorphers,47046221,22806,6311,16495,2022-02-06
4837,The Martingale Agency,Brand Publicity,GI-Bro,10193346,22789,17674,5115,2022-01-27
758,Google Inc.,Influencer,Merf,82763152,22766,6447,16319,2022-01-05
1245,Pinterest Inc,Brand Publicity,Merf,36857508,22752,16997,5755,2022-02-01
4583,Pinterest Inc,Media Supported Asset,GI-Bro,96253243,22673,7127,15546,2022-03-10
3579,Pinterest Inc,Influencer,Transmorphers,33644694,22660,16861,5799,2022-04-05
1025,Google Inc.,E-Commerce,Transmorphers,11082384,22645,21710,935,2022-05-04
4960,Disney Studios,E-Commerce,Clay-Dough,56962934,22613,13087,9526,2022-05-30
1268,KYG Antler LLC,Media Supported Asset,Space Wars,41033824,22592,5736,16856,2022-03-08
4284,Pinterest Inc,Brand Publicity,Transmorphers,73786940,22579,13270,9309,2022-06-14
4614,The Martingale Agency,Influencer,Space Wars,58505894,22558,5852,16706,2022-01-24
3486,Pinterest Inc,E-Commerce,Merf,40585990,22421,18536,3885,2022-03-27
676,Disney Studios,Influencer,Transmorphers,66555013,22408,7634,14774,2022-04-13
2142,Pinterest Inc,Brand Asset Development,GI-Bro,53905913,22223,1589,20634,2022-03-24
158,The Martingale Agency,E-Commerce,Clay-Dough,50525886,22187,15799,6388,2022-06-18
4604,Nintendo Technologies,Influencer,GI-Bro,78642950,22140,10234,11906,2022-05-25
880,Meta Platforms,Media Supported Asset,Space Wars,52156672,22055,20336,1719,2022-06-10
2480,Nintendo Technologies,Influencer,Transmorphers,77908162,22003,19848,2155,2022-01-27
2927,Nintendo Technologies,Media Supported Asset,Space Wars,70497039,21902,17310,4592,2022-04-27
3813,Google Inc.,Influencer,GI-Bro,92552988,21888,12131,9757,2022-04-02
492,TikTok Inc,E-Commerce,Space Wars,82165041,21790,16613,5177,2022-05-18
4613,The Martingale Agency,Brand Asset Development,GI-Bro,31425386,21790,12639,9151,2022-05-23
1619,Disney Studios,Influencer,Merf,71811558,21778,1727,20051,2022-01-25
3033,Disney Studios,Brand Asset Development,Merf,21848783,21733,310,21423,2022-01-24
1282,Google Inc.,Brand Publicity,Merf,64816312,21684,6274,15410,2022-03-14
2701,Disney Studios,E-Commerce,Space Wars,74687034,21641,16408,5233,2022-01-14
3006,KYG Antler LLC,Brand Asset Development,GI-Bro,30729318,21616,7783,13833,2022-06-26
1399,Nintendo Technologies,Influencer,Transmorphers,22475565,21548,11543,10005,2022-01-31
3870,KYG Antler LLC,Media Supported Asset,Transmorphers,15518119,21534,14397,7137,2022-06-17
3076,Google Inc.,Media Supported Asset,Transmorphers,21784879,21522,5444,16078,2022-05-29
2851,Pinterest Inc,Media Supported Asset,GI-Bro,65816210,21487,18241,3246,2022-02-07
1744,The Martingale Agency,E-Commerce,GI-Bro,76170893,21449,2065,19384,2022-06-04
191,Pinterest Inc,Brand Asset Development,Transmorphers,51796393,21438,14600,6838,2022-04-01
4856,Nintendo Technologies,Brand Publicity,Merf,17850970,21362,15516,5846,2022-02-16
3418,Nintendo Technologies,Influencer,Space Wars,32084088,21344,3764,17580,2022-03-17
2587,TikTok Inc,E-Commerce,GI-Bro,28645731,21244,12252,8992,2022-04-14
702,Pinterest Inc,Brand Publicity,Space Wars,41470714,21174,20452,722,2022-02-14
946,KYG Antler LLC,Media Supported Asset,Space Wars,75956897,20994,13942,7052,2022-03-27
1553,Pinterest Inc,Brand Publicity,Merf,19651577,20910,1291,19619,2022-01-25
1779,Disney Studios,Brand Asset Development,Transmorphers,68730718,20861,16586,4275,2022-04-02
1632,Meta Platforms,E-Commerce,Transmorphers,90367949,20839,122,20717,2022-06-16
417,Disney Studios,Brand Publicity,Space Wars,96433337,20799,20653,146,2022-03-22
3588,Google Inc.,Brand Publicity,Clay-Dough,45765520,20790,2977,17813,2022-04-24
996,Google Inc.,Brand Publicity,Merf,97116966,20718,7668,13050,2022-02-24
4310,Google Inc.,E-Commerce,Transmorphers,52587018,20685,3776,16909,2022-01-24
2316,Nintendo Technologies,Brand Publicity,Clay-Dough,49416750,20637,7981,12656,2022-06-19
2079,KYG Antler LLC,Influencer,Clay-Dough,77770002,20602,17455,3147,2022-06-30
1981,Disney Studios,E-Commerce,GI-Bro,23787971,20557,19580,977,2022-02-28
1208,The Martingale Agency,Brand Publicity,Transmorphers,64934253,20500,16200,4300,2022-01-08
873,Nintendo Technologies,Brand Asset Development,Clay-Dough,39776878,20494,14582,5912,2022-04-23
1993,Google Inc.,E-Commerce,GI-Bro,26302220,20476,3868,16608,2022-01-21
741,Meta Platforms,Influencer,GI-Bro,19290007,20458,1055,19403,2022-04-05
2227,Google Inc.,Media Supported Asset,Merf,50602934,20351,18195,2156,2022-06-20
4731,Pinterest Inc,Brand Publicity,GI-Bro,50373376,20291,9004,11287,2022-02-06
4766,Pinterest Inc,Influencer,GI-Bro,51427233,20207,17888,2319,2022-04-27
4958,Disney Studios,Influencer,Merf,19517680,20204,4783,15421,2022-01-27
675,Nintendo Technologies,Brand Publicity,GI-Bro,57481308,20177,6936,13241,2022-02-10
2754,The Martingale Agency,Brand Asset Development,Space Wars,69696281,20143,10119,10024,2022-03-18
3619,Nintendo Technologies,E-Commerce,Merf,22842222,20135,7588,12547,2022-05-20
1324,Pinterest Inc,E-Commerce,Merf,71861044,20119,733,19386,2022-05-27
4049,The Martingale Agency,Influencer,Space Wars,23646564,20113,11549,8564,2022-02-21
283,Disney Studios,Brand Publicity,GI-Bro,64152389,20081,16457,3624,2022-03-24
1732,KYG Antler LLC,Brand Asset Development,Space Wars,32776347,20038,2581,17457,2022-05-09
3606,The Martingale Agency,Influencer,Space Wars,10855748,20012,14022,5990,2022-01-29
2934,Google Inc.,Brand Publicity,Clay-Dough,33623716,19996,11511,8485,2022-06-16
4185,Meta Platforms,E-Commerce,Clay-Dough,92738613,19949,17152,2797,2022-01-10
2075,Nintendo Technologies,Influencer,Transmorphers,66348578,19936,19648,288,2022-05-10
3394,Google Inc.,Brand Publicity,Clay-Dough,49987285,19900,6074,13826,2022-02-22
1575,Meta Platforms,Influencer,Clay-Dough,97661116,19895,4502,15393,2022-06-29
277,Nintendo Technologies,Influencer,Transmorphers,34016841,19841,18730,1111,2022-01-13
3740,The Martingale Agency,Media Supported Asset,Merf,21876413,19809,8345,11464,2022-05-26
2945,Nintendo Technologies,Brand Asset Development,Space Wars,49603296,19716,7875,11841,2022-05-05
4324,Pinterest Inc,Brand Asset Development,Merf,70164574,19704,14469,5235,2022-01-12
2510,KYG Antler LLC,Media Supported Asset,Merf,40314247,19685,8793,10892,2022-02-14
2624,Disney Studios,Influencer,Merf,69191992,19679,7480,12199,2022-03-31
1213,Pinterest Inc,Media Supported Asset,GI-Bro,42764931,19656,16627,3029,2022-03-15
4033,The Martingale Agency,E-Commerce,Clay-Dough,95271627,19608,13677,5931,2022-05-31
3271,KYG Antler LLC,Brand Asset Development,Space Wars,55934314,19584,553,19031,2022-05-09
2083,Nintendo Technologies,Influencer,Clay-Dough,65762751,19577,13168,6409,2022-06-14
1299,TikTok Inc,Influencer,GI-Bro,28178305,19575,18921,654,2022-01-17
1856,The Martingale Agency,Brand Publicity,GI-Bro,15821058,19519,15106,4413,2022-05-02
1258,Pinterest Inc,Influencer,Space Wars,57423820,19398,3038,16360,2022-04-16
1645,TikTok Inc,E-Commerce,Space Wars,37725014,19233,12360,6873,2022-05-29
2839,The Martingale Agency,E-Commerce,Clay-Dough,98574675,19196,3603,15593,2022-01-31
962,TikTok Inc,Media Supported Asset,Transmorphers,99360603,19100,16796,2304,2022-04-21
3133,Pinterest Inc,Influencer,GI-Bro,48972095,18990,2245,16745,2022-03-24
595,KYG Antler LLC,Media Supported Asset,Transmorphers,74210627,18900,2274,16626,2022-05-31
1217,KYG Antler LLC,Brand Asset Development,GI-Bro,43112788,18814,10897,7917,2022-01-07
4313,Google Inc.,E-Commerce,Space Wars,68670285,18785,5276,13509,2022-06-03
2933,Nintendo Technologies,Media Supported Asset,GI-Bro,70319849,18731,11768,6963,2022-05-25
3185,Pinterest Inc,Brand Asset Development,Space Wars,34298762,18649,10643,8006,2022-05-30
1549,Nintendo Technologies,E-Commerce,GI-Bro,76791541,18619,11479,7140,2022-02-24
2448,The Martingale Agency,Influencer,Clay-Dough,42662301,18608,17067,1541,2022-05-01
2481,Google Inc.,Media Supported Asset,GI-Bro,39391094,18544,6302,12242,2022-06-01
407,The Martingale Agency,Brand Asset Development,Clay-Dough,69586934,18491,9424,9067,2022-02-19
2870,KYG Antler LLC,E-Commerce,Transmorphers,49632692,18458,15148,3310,2022-01-27
2798,The Martingale Agency,Brand Asset Development,Clay-Dough,67995566,18455,3880,14575,2022-05-26
4013,TikTok Inc,Influencer,GI-Bro,64788906,18230,1761,16469,2022-03-23
192,The Martingale Agency,E-Commerce,GI-Bro,36296783,18222,3673,14549,2022-02-01
1854,Pinterest Inc,Brand Asset Development,Merf,48056023,18132,16969,1163,2022-03-24
4468,Nintendo Technologies,Media Supported Asset,Clay-Dough,33888048,18112,16835,1277,2022-03-03
1287,Nintendo Technologies,Influencer,Transmorphers,40807261,18062,17842,220,2022-03-14
1145,Pinterest Inc,Brand Asset Development,Space Wars,88168771,17920,7862,10058,2022-02-20
1111,TikTok Inc,Brand Publicity,Merf,58763076,17896,1412,16484,2022-03-13
190,Pinterest Inc,E-Commerce,Clay-Dough,89323874,17673,1625,16048,2022-04-08
3991,Nintendo Technologies,Media Supported Asset,Merf,49631153,17660,1361,16299,2022-03-25
3298,Nintendo Technologies,Influencer,Transmorphers,10474963,17651,10962,6689,2022-04-06
4014,Google Inc.,Brand Publicity,Space Wars,62492776,17477,15239,2238,2022-02-19
4510,The Martingale Agency,E-Commerce,Transmorphers,35046054,17403,1347,16056,2022-06-06
4039,TikTok Inc,Brand Publicity,Space Wars,87583715,17377,16136,1241,2022-06-12
1370,KYG Antler LLC,Media Supported Asset,Merf,51406696,17369,14523,2846,2022-06-24
604,Disney Studios,Influencer,Transmorphers,50587873,17339,1441,15898,2022-05-24
4395,Meta Platforms,E-Commerce,Clay-Dough,13844767,17289,12440,4849,2022-03-21
3235,The Martingale Agency,Influencer,Merf,83976201,17216,11852,5364,2022-01-23
2586,Disney Studios,E-Commerce,Transmorphers,51103849,17145,11031,6114,2022-02-04
870,The Martingale Agency,Brand Publicity,Transmorphers,70733503,17139,9859,7280,2022-05-26
1796,Disney Studios,Brand Publicity,Transmorphers,99295811,17069,8796,8273,2022-06-29
906,Pinterest Inc,Media Supported Asset,Merf,50010133,17060,15431,1629,2022-04-11
3189,Nintendo Technologies,Influencer,Space Wars,81073833,17019,7342,9677,2022-04-26
1798,TikTok Inc,Brand Publicity,Transmorphers,25207388,16996,4476,12520,2022-02-07
4096,The Martingale Agency,E-Commerce,Merf,55106531,16989,1208,15781,2022-01-12
389,Google Inc.,Influencer,Space Wars,83334583,16985,395,16590,2022-06-18
3243,Disney Studios,Media Supported Asset,Space Wars,89886568,16943,12717,4226,2022-03-17
1894,Disney Studios,Brand Publicity,GI-Bro,56910842,16697,9015,7682,2022-05-20
3079,Nintendo Technologies,E-Commerce,Space Wars,88790942,16686,11620,5066,2022-06-06
4689,Google Inc.,Brand Asset Development,Clay-Dough,72409642,16680,6991,9689,2022-05-03
1247,Disney Studios,Influencer,Merf,38384638,16677,10084,6593,2022-04-15
3774,Meta Platforms,Brand Publicity,Clay-Dough,20961672,16587,2804,13783,2022-02-26
1790,TikTok Inc,E-Commerce,Merf,81175145,16586,11399,5187,2022-04-17
4908,The Martingale Agency,Brand Publicity,GI-Bro,20243589,16580,5466,11114,2022-01-03
2936,Disney Studios,Influencer,Clay-Dough,26852480,16533,11722,4811,2022-03-02
3711,Disney Studios,Brand Publicity,Transmorphers,29817594,16448,9057,7391,2022-06-14
653,The Martingale Agency,Brand Asset Development,GI-Bro,97453369,16441,9516,6925,2022-02-18
2210,Nintendo Technologies,Influencer,Transmorphers,11311679,16432,213,16219,2022-06-17
2122,KYG Antler LLC,Media Supported Asset,Transmorphers,87793008,16425,15322,1103,2022-02-23
1662,Disney Studios,Brand Publicity,Space Wars,68036314,16399,14286,2113,2022-06-02
3268,KYG Antler LLC,Influencer,Clay-Dough,72887545,16396,10211,6185,2022-02-03
108,Google Inc.,Media Supported Asset,Transmorphers,27700604,16388,13772,2616,2022-03-27
4322,Nintendo Technologies,E-Commerce,GI-Bro,15547621,16295,5165,11130,2022-05-16
1272,Meta Platforms,Brand Publicity,Transmorphers,46887120,16216,8182,8034,2022-06-17
1187,Meta Platforms,Brand Publicity,Clay-Dough,52539423,16192,12359,3833,2022-01-24
1877,Meta Platforms,E-Commerce,Clay-Dough,55496134,16180,9159,7021,2022-04-20
1800,The Martingale Agency,Brand Publicity,Transmorphers,63778362,16158,15835,323,2022-01-18
4392,Pinterest Inc,Brand Asset Development,GI-Bro,21307973,16135,8298,7837,2022-01-08
168,Nintendo Technologies,E-Commerce,Transmorphers,80621225,16129,5607,10522,2022-02-27
1002,Google Inc.,E-Commerce,Space Wars,53208046,16104,5367,10737,2022-04-05
1565,The Martingale Agency,Brand Asset Development,Merf,76896751,16081,10970,5111,2022-02-18
667,Meta Platforms,E-Commerce,Transmorphers,94093097,16067,13089,2978,2022-06-09
2168,TikTok Inc,Media Supported Asset,GI-Bro,46212427,16062,2871,13191,2022-03-04
662,Nintendo Technologies,Influencer,Transmorphers,35508407,16056,6697,9359,2022-06-17
228,Disney Studios,Brand Asset Development,Merf,55374505,16025,12081,3944,2022-05-02
2640,Disney Studios,Influencer,GI-Bro,12629510,16016,7343,8673,2022-06-01
4553,The Martingale Agency,Brand Publicity,Clay-Dough,20128199,16014,6673,9341,2022-04-23
465,Google Inc.,E-Commerce,Merf,51324288,16004,6940,9064,2022-03-10
2528,The Martingale Agency,Media Supported Asset,Clay-Dough,44108267,15999,8268,7731,2022-01-27
2675,TikTok Inc,E-Commerce,Clay-Dough,66503686,15988,8593,7395,2022-02-22
2713,The Martingale Agency,Brand Publicity,Transmorphers,34457918,15904,1081,14823,2022-05-16
1427,TikTok Inc,Brand Publicity,Merf,65895539,15901,14926,975,2022-01-15
145,TikTok Inc,Brand Publicity,Space Wars,57301355,15762,12220,3542,2022-06-02
795,Disney Studios,Brand Publicity,Merf,25193763,15677,979,14698,2022-05-01
517,Google Inc.,Brand Publicity,GI-Bro,52061084,15660,9388,6272,2022-01-16
4692,Disney Studios,Influencer,GI-Bro,75941356,15641,9351,6290,2022-04-27
1716,Meta Platforms,E-Commerce,GI-Bro,25140725,15636,82,15554,2022-03-05
4232,Meta Platforms,Brand Publicity,GI-Bro,55162389,15595,9806,5789,2022-03-19
4419,TikTok Inc,Brand Asset Development,Merf,73298114,15538,6718,8820,2022-01-05
1095,Disney Studios,Brand Publicity,Transmorphers,19291505,15524,14169,1355,2022-04-25
2815,Meta Platforms,E-Commerce,GI-Bro,25285144,15515,11865,3650,2022-04-03
887,The Martingale Agency,Media Supported Asset,Transmorphers,20285111,15472,6852,8620,2022-02-19
851,Google Inc.,Influencer,Transmorphers,30284567,15431,7648,7783,2022-06-22
1171,Meta Platforms,Brand Asset Development,Space Wars,74738662,15420,3226,12194,2022-02-23
2,Pinterest Inc,Influencer,Space Wars,52947569,15396,9520,5876,2022-03-04
2182,KYG Antler LLC,Media Supported Asset,Merf,27087737,15292,13199,2093,2022-02-11
3565,KYG Antler LLC,Brand Publicity,GI-Bro,27143125,15285,2915,12370,2022-06-21
3684,Meta Platforms,Influencer,Clay-Dough,85012552,15273,5401,9872,2022-03-17
3420,The Martingale Agency,Brand Publicity,Clay-Dough,65930043,15257,7514,7743,2022-01-02
2983,Pinterest Inc,Brand Asset Development,GI-Bro,54937598,15227,1247,13980,2022-02-16
3519,The Martingale Agency,Brand Publicity,Transmorphers,58059731,15224,14956,268,2022-04-23
2004,Nintendo Technologies,Brand Publicity,Merf,53803885,15222,408,14814,2022-03-23
586,Nintendo Technologies,Brand Publicity,Clay-Dough,14333576,15197,12491,2706,2022-03-21
3719,KYG Antler LLC,Media Supported Asset,Transmorphers,69157552,15140,959,14181,2022-05-07
1242,Nintendo Technologies,Brand Asset Development,Space Wars,10709253,15125,10362,4763,2022-06-03
778,Nintendo Technologies,Media Supported Asset,Space Wars,57067445,15081,5701,9380,2022-04-25
4189,The Martingale Agency,E-Commerce,GI-Bro,27045572,15072,3468,11604,2022-06-24
2005,Disney Studios,Brand Asset Development,GI-Bro,41031264,15032,11484,3548,2022-01-02
2213,Google Inc.,Brand Publicity,Transmorphers,56343752,15032,1925,13107,2022-06-12
1429,Google Inc.,Media Supported Asset,Merf,45445041,14898,11223,3675,2022-02-04
4675,Disney Studios,E-Commerce,Transmorphers,39042621,14863,244,14619,2022-04-08
1725,The Martingale Agency,Brand Asset Development,GI-Bro,17492798,14842,7783,7059,2022-03-18
4750,The Martingale Agency,Brand Asset Development,Clay-Dough,37746514,14828,6253,8575,2022-01-27
2590,Pinterest Inc,Brand Publicity,GI-Bro,15303655,14757,7102,7655,2022-06-12
174,KYG Antler LLC,Influencer,Space Wars,21899277,14687,14484,203,2022-01-01
972,KYG Antler LLC,Brand Asset Development,Transmorphers,32529465,14623,1181,13442,2022-01-05
2486,TikTok Inc,Brand Publicity,Space Wars,58733371,14591,1793,12798,2022-05-03
4654,Meta Platforms,Influencer,Merf,31416987,14581,3004,11577,2022-04-26
3931,Google Inc.,Brand Asset Development,GI-Bro,66543427,14504,8041,6463,2022-04-16
3379,KYG Antler LLC,Brand Publicity,Transmorphers,80704163,14479,5771,8708,2022-01-02
858,The Martingale Agency,Influencer,Merf,37399241,14424,7106,7318,2022-04-08
2334,The Martingale Agency,Brand Publicity,Transmorphers,56848345,14376,6236,8140,2022-06-26
3290,Google Inc.,E-Commerce,Merf,73299107,14352,11306,3046,2022-06-09
265,The Martingale Agency,E-Commerce,Merf,53082012,14276,4695,9581,2022-05-29
4633,KYG Antler LLC,Brand Asset Development,Space Wars,45015193,14220,10624,3596,2022-06-12
4994,TikTok Inc,Media Supported Asset,GI-Bro,96609192,14168,2598,11570,2022-01-31
4693,Nintendo Technologies,Brand Publicity,Merf,99098722,14116,11655,2461,2022-04-23
2464,Pinterest Inc,Brand Asset Development,Clay-Dough,18537222,14113,10014,4099,2022-01-11
4439,TikTok Inc,Brand Asset Development,GI-Bro,68167430,14109,9309,4800,2022-06-09
489,TikTok Inc,Influencer,Clay-Dough,48690633,14028,10974,3054,2022-06-11
4706,Google Inc.,E-Commerce,Clay-Dough,67305336,14001,7825,6176,2022-04-12
2019,KYG Antler LLC,Brand Asset Development,Merf,22188898,13975,4502,9473,2022-02-09
1895,The Martingale Agency,Influencer,Space Wars,12582460,13881,4135,9746,2022-01-24
726,TikTok Inc,Influencer,Transmorphers,64324851,13853,10145,3708,2022-06-28
1843,The Martingale Agency,Media Supported Asset,Transmorphers,35975945,13841,8436,5405,2022-06-19
4575,Nintendo Technologies,E-Commerce,Merf,77476411,13760,13692,68,2022-06-13
71,Pinterest Inc,Influencer,Merf,46158812,13746,4337,9409,2022-05-18
860,Disney Studios,E-Commerce,Merf,79179365,13724,1575,12149,2022-05-06
2270,Pinterest Inc,Media Supported Asset,Transmorphers,13512701,13693,5090,8603,2022-06-29
4714,Meta Platforms,E-Commerce,GI-Bro,45182681,13669,849,12820,2022-06-12
4336,TikTok Inc,Brand Publicity,Space Wars,36948999,13667,11895,1772,2022-03-11
2972,Pinterest Inc,Influencer,Merf,13802744,13657,7588,6069,2022-01-08
254,KYG Antler LLC,Influencer,Transmorphers,14067606,13630,12483,1147,2022-06-11
2452,KYG Antler LLC,Brand Asset Development,Transmorphers,92677614,13600,7329,6271,2022-05-23
2206,Disney Studios,E-Commerce,Space Wars,13563721,13598,3883,9715,2022-01-24
3516,TikTok Inc,Brand Publicity,Transmorphers,19142423,13569,11891,1678,2022-02-25
1049,KYG Antler LLC,Brand Asset Development,GI-Bro,55436118,13541,7716,5825,2022-02-20
3409,KYG Antler LLC,E-Commerce,Clay-Dough,74533402,13536,8720,4816,2022-05-17
746,Meta Platforms,Media Supported Asset,GI-Bro,92529525,13516,3618,9898,2022-05-27
3423,KYG Antler LLC,Brand Asset Development,Merf,90397561,13499,13091,408,2022-02-17
4252,TikTok Inc,Brand Publicity,Merf,16428042,13497,9632,3865,2022-02-07
2695,Pinterest Inc,Influencer,Merf,17459956,13427,3234,10193,2022-01-10
2265,Google Inc.,Brand Asset Development,Transmorphers,95135022,13398,11235,2163,2022-02-15
4565,Pinterest Inc,E-Commerce,Space Wars,86221034,13396,11825,1571,2022-03-25
3163,Nintendo Technologies,Brand Asset Development,Clay-Dough,13584686,13298,9279,4019,2022-01-10
1005,TikTok Inc,E-Commerce,Space Wars,21122640,13280,6752,6528,2022-03-15
3749,The Martingale Agency,Brand Publicity,Clay-Dough,56438011,13217,11696,1521,2022-01-22
1273,Pinterest Inc,E-Commerce,Space Wars,94251392,13207,5667,7540,2022-03-21
3473,Meta Platforms,E-Commerce,Space Wars,35064822,13179,4196,8983,2022-03-13
2111,The Martingale Agency,Influencer,GI-Bro,90165629,13113,7879,5234,2022-01-27
2395,Nintendo Technologies,Brand Asset Development,Clay-Dough,29616329,13026,8373,4653,2022-06-18
2146,KYG Antler LLC,Media Supported Asset,Space Wars,80855429,13016,8640,4376,2022-03-11
1414,Pinterest Inc,E-Commerce,GI-Bro,78916937,12958,12250,708,2022-06-22
4893,TikTok Inc,Brand Asset Development,Transmorphers,63292978,12912,10902,2010,2022-05-29
2854,TikTok Inc,Media Supported Asset,Merf,89821773,12848,393,12455,2022-05-24
2415,Meta Platforms,Media Supported Asset,Transmorphers,32248162,12845,7337,5508,2022-04-12
1104,The Martingale Agency,E-Commerce,Clay-Dough,49345284,12758,5300,7458,2022-03-04
3929,Google Inc.,Media Supported Asset,Merf,45865303,12751,9125,3626,2022-02-27
1750,TikTok Inc,Media Supported Asset,GI-Bro,12862001,12711,10984,1727,2022-06-05
266,Pinterest Inc,Media Supported Asset,Space Wars,28014931,12649,10598,2051,2022-03-06
618,Meta Platforms,Media Supported Asset,Transmorphers,16104410,12629,3119,9510,2022-06-01
2647,Nintendo Technologies,Brand Asset Development,GI-Bro,76459513,12590,2447,10143,2022-04-21
4898,Pinterest Inc,Influencer,Merf,77589492,12533,3824,8709,2022-05-28
3988,TikTok Inc,E-Commerce,GI-Bro,18350507,12506,101,12405,2022-01-02
4597,Google Inc.,E-Commerce,Clay-Dough,92734118,12313,795,11518,2022-06-17
4656,Pinterest Inc,E-Commerce,GI-Bro,30793324,12287,6858,5429,2022-04-10
4278,Google Inc.,Brand Publicity,Transmorphers,90282953,12277,3520,8757,2022-04-24
2687,Google Inc.,Media Supported Asset,Transmorphers,43840468,12262,9716,2546,2022-04-16
457,Meta Platforms,Influencer,Clay-Dough,86319369,12218,2539,9679,2022-01-15
732,TikTok Inc,Media Supported Asset,Space Wars,61242287,12158,380,11778,2022-05-22
1697,The Martingale Agency,E-Commerce,Space Wars,59212732,12089,8876,3213,2022-01-29
3503,The Martingale Agency,Brand Asset Development,Space Wars,90544687,12034,5773,6261,2022-01-21
1375,Nintendo Technologies,Media Supported Asset,Clay-Dough,96301367,12029,6146,5883,2022-03-05
3663,Disney Studios,Brand Asset Development,Transmorphers,34015075,11910,4391,7519,2022-02-08
3820,Disney Studios,E-Commerce,Space Wars,77052403,11892,7858,4034,2022-01-17
1860,Pinterest Inc,Brand Publicity,Clay-Dough,87742585,11886,8941,2945,2022-03-31
4581,Disney Studios,Media Supported Asset,Transmorphers,26960660,11869,11167,702,2022-04-23
3861,KYG Antler LLC,Brand Asset Development,GI-Bro,87723143,11867,10670,1197,2022-02-02
552,KYG Antler LLC,Brand Publicity,Space Wars,87851914,11865,2632,9233,2022-02-14
4880,The Martingale Agency,Brand Asset Development,GI-Bro,52058582,11750,1949,9801,2022-04-17
1589,KYG Antler LLC,Brand Asset Development,Merf,54594233,11735,3774,7961,2022-05-15
1908,The Martingale Agency,Media Supported Asset,Transmorphers,99763619,11712,1837,9875,2022-06-04
4753,Meta Platforms,Media Supported Asset,Space Wars,78596512,11612,1226,10386,2022-02-15
177,Google Inc.,E-Commerce,Space Wars,36405747,11515,313,11202,2022-01-17
4208,TikTok Inc,Brand Publicity,Merf,67870996,11494,3305,8189,2022-03-13
602,TikTok Inc,Media Supported Asset,Transmorphers,24662516,11404,4592,6812,2022-01-14
1499,The Martingale Agency,Brand Publicity,Merf,41513785,11391,3106,8285,2022-06-07
2567,KYG Antler LLC,E-Commerce,Space Wars,43051711,11346,1627,9719,2022-03-02
1797,KYG Antler LLC,Brand Publicity,Clay-Dough,49952206,11303,420,10883,2022-04-02
4478,Disney Studios,Brand Publicity,Clay-Dough,75576994,11295,7000,4295,2022-01-20
3582,Nintendo Technologies,E-Commerce,Merf,52568282,11253,1868,9385,2022-05-23
764,Meta Platforms,Brand Publicity,Merf,61372452,11241,6831,4410,2022-01-07
3708,Pinterest Inc,Media Supported Asset,Transmorphers,36839774,11089,10469,620,2022-06-27
848,Meta Platforms,Brand Publicity,Space Wars,57674413,11074,4819,6255,2022-01-09
3129,The Martingale Agency,E-Commerce,GI-Bro,38457019,11034,10325,709,2022-02-18
1587,TikTok Inc,Media Supported Asset,Transmorphers,68874190,10999,5899,5100,2022-05-05
2632,The Martingale Agency,Influencer,Merf,44384150,10917,3980,6937,2022-05-15
4728,Disney Studios,Brand Asset Development,Clay-Dough,42093506,10913,7294,3619,2022-05-03
3683,Meta Platforms,Brand Publicity,Transmorphers,24838934,10909,2021,8888,2022-05-05
0,Disney Studios,E-Commerce,Merf,35452944,10778,6754,4024,2022-05-25
3981,Pinterest Inc,Media Supported Asset,Merf,11925053,10742,2707,8035,2022-06-22
4965,Google Inc.,Media Supported Asset,Clay-Dough,90769929,10728,3430,7298,2022-05-18
948,The Martingale Agency,Influencer,Merf,73796473,10658,2499,8159,2022-01-15
2992,Meta Platforms,Influencer,Merf,52380808,10613,5205,5408,2022-05-07
1068,The Martingale Agency,Influencer,Transmorphers,66653769,10565,855,9710,2022-01-14
4971,Nintendo Technologies,Brand Publicity,Space Wars,36334055,10557,5118,5439,2022-05-11
895,TikTok Inc,Media Supported Asset,Merf,60906189,10543,1193,9350,2022-01-29
1857,Pinterest Inc,Brand Publicity,Merf,51416493,10528,8119,2409,2022-03-09
3424,Nintendo Technologies,E-Commerce,Clay-Dough,33370318,10471,7661,2810,2022-03-26
1364,Google Inc.,E-Commerce,GI-Bro,27824171,10442,5385,5057,2022-04-16
1058,Disney Studios,Influencer,Space Wars,50630866,10424,3457,6967,2022-01-25
2930,The Martingale Agency,Brand Publicity,Transmorphers,65770569,10406,9066,1340,2022-04-14
257,The Martingale Agency,Brand Asset Development,GI-Bro,81523286,10382,4994,5388,2022-01-18
4884,The Martingale Agency,Brand Publicity,GI-Bro,74599909,10333,2647,7686,2022-02-16
173,Google Inc.,Brand Asset Development,Space Wars,45082037,10170,3054,7116,2022-06-23
1491,The Martingale Agency,Influencer,GI-Bro,45748189,10153,4583,5570,2022-03-19
909,Disney Studios,Brand Publicity,Space Wars,56597486,10130,7896,2234,2022-01-23
3580,The Martingale Agency,Brand Asset Development,Clay-Dough,27547564,10058,5934,4124,2022-04-15
3699,Meta Platforms,Brand Publicity,GI-Bro,22776204,9947,7639,2308,2022-01-30
920,TikTok Inc,Influencer,Merf,71728125,9911,1620,8291,2022-03-13
104,Disney Studios,E-Commerce,Merf,62671378,9894,3536,6358,2022-05-14
683,Google Inc.,Brand Asset Development,Clay-Dough,58184431,9875,3442,6433,2022-02-14
508,Disney Studios,Media Supported Asset,Merf,17755969,9838,2247,7591,2022-06-29
3532,Google Inc.,E-Commerce,Transmorphers,69245324,9829,3113,6716,2022-01-08
2777,The Martingale Agency,E-Commerce,Transmorphers,47577347,9733,5840,3893,2022-03-05
4590,Meta Platforms,Brand Asset Development,Transmorphers,19508680,9728,8442,1286,2022-04-08
4157,KYG Antler LLC,E-Commerce,Merf,84948566,9709,8045,1664,2022-05-17
1351,TikTok Inc,Brand Asset Development,GI-Bro,54971833,9678,1320,8358,2022-04-02
4416,KYG Antler LLC,E-Commerce,Transmorphers,48053243,9673,4908,4765,2022-05-31
4998,TikTok Inc,Influencer,Clay-Dough,18156527,9669,9590,79,2022-03-22
1148,Pinterest Inc,Media Supported Asset,Transmorphers,62105835,9658,2583,7075,2022-05-08
3955,Nintendo Technologies,Brand Asset Development,Transmorphers,18728007,9568,6122,3446,2022-05-21
2954,Disney Studios,Brand Asset Development,GI-Bro,66254161,9514,1017,8497,2022-01-05
3152,TikTok Inc,Media Supported Asset,Space Wars,40152540,9487,2253,7234,2022-01-13
2757,KYG Antler LLC,E-Commerce,Space Wars,94748289,9405,2794,6611,2022-02-15
2470,KYG Antler LLC,Influencer,GI-Bro,93542026,9361,4355,5006,2022-06-25
1026,Meta Platforms,E-Commerce,Merf,13734111,9342,7259,2083,2022-06-09
1593,Disney Studios,Media Supported Asset,GI-Bro,51678844,9332,716,8616,2022-02-02
2872,The Martingale Agency,Brand Publicity,Transmorphers,83774697,9323,8215,1108,2022-06-14
1038,The Martingale Agency,Brand Asset Development,Transmorphers,12161403,9321,7030,2291,2022-04-17
4085,KYG Antler LLC,Influencer,Space Wars,37110556,9315,8223,1092,2022-04-29
4174,The Martingale Agency,Brand Publicity,GI-Bro,56520294,9261,4657,4604,2022-04-17
4345,TikTok Inc,Influencer,Space Wars,55414447,9192,3139,6053,2022-05-26
885,Nintendo Technologies,Brand Publicity,Space Wars,39756940,9183,6407,2776,2022-06-22
3055,Pinterest Inc,Brand Publicity,Space Wars,16861153,9047,6119,2928,2022-02-01
1497,Meta Platforms,Brand Asset Development,GI-Bro,21104468,9039,7948,1091,2022-04-05
4141,Nintendo Technologies,Media Supported Asset,Merf,69152682,8868,1281,7587,2022-05-17
4244,TikTok Inc,E-Commerce,Space Wars,68444938,8840,8787,53,2022-06-01
3389,Meta Platforms,Brand Asset Development,Space Wars,37615416,8785,805,7980,2022-03-21
51,Google Inc.,Influencer,Clay-Dough,93507672,8732,5156,3576,2022-03-05
3894,Disney Studios,Brand Publicity,Space Wars,43832142,8714,2750,5964,2022-04-11
1141,Meta Platforms,Media Supported Asset,Space Wars,77858631,8651,2671,5980,2022-05-16
945,Pinterest Inc,E-Commerce,Merf,32275523,8590,442,8148,2022-04-26
1114,TikTok Inc,Media Supported Asset,Space Wars,52394633,8586,3407,5179,2022-01-05
899,Meta Platforms,E-Commerce,Merf,16007629,8507,6133,2374,2022-06-21
3332,Google Inc.,Influencer,Transmorphers,19190529,8459,7901,558,2022-01-11
209,Google Inc.,Influencer,Clay-Dough,58164136,8402,4041,4361,2022-06-14
3658,TikTok Inc,Media Supported Asset,Space Wars,29852096,8333,4643,3690,2022-05-19
4134,TikTok Inc,Media Supported Asset,GI-Bro,94637568,8274,6034,2240,2022-02-22
4388,The Martingale Agency,Brand Asset Development,Transmorphers,59569679,8273,3338,4935,2022-03-28
2314,Pinterest Inc,Media Supported Asset,Space Wars,72205808,8258,3636,4622,2022-01-03
3502,Pinterest Inc,Influencer,Clay-Dough,30483059,8257,5621,2636,2022-01-20
2616,Google Inc.,Media Supported Asset,Space Wars,92987486,8255,565,7690,2022-01-01
346,TikTok Inc,Brand Publicity,Space Wars,11849435,8155,799,7356,2022-06-16
4580,Disney Studios,Brand Publicity,Transmorphers,96739981,8108,3772,4336,2022-06-24
3734,TikTok Inc,Influencer,Space Wars,77685630,8027,6899,1128,2022-01-21
3344,Meta Platforms,Influencer,GI-Bro,84917915,8001,1625,6376,2022-05-01
3654,TikTok Inc,Brand Publicity,Space Wars,62395192,7998,3213,4785,2022-06-08
4660,KYG Antler LLC,Brand Asset Development,Clay-Dough,38770126,7988,7875,113,2022-02-26
2374,Google Inc.,Brand Publicity,Space Wars,13056832,7976,2091,5885,2022-02-01
1129,Pinterest Inc,Media Supported Asset,Transmorphers,31522830,7922,6375,1547,2022-01-05
2656,Nintendo Technologies,E-Commerce,Merf,17954016,7907,3231,4676,2022-03-02
1170,Meta Platforms,Brand Publicity,Space Wars,95551757,7881,5333,2548,2022-03-31
4480,TikTok Inc,Influencer,Space Wars,39037606,7853,5853,2000,2022-05-09
3878,Meta Platforms,E-Commerce,Clay-Dough,72023478,7817,6008,1809,2022-01-28
2827,The Martingale Agency,Brand Asset Development,Space Wars,53617398,7800,6272,1528,2022-03-16
1160,The Martingale Agency,Brand Asset Development,Clay-Dough,10387725,7789,4544,3245,2022-06-12
2050,KYG Antler LLC,Influencer,Merf,55885266,7723,6396,1327,2022-03-25
3970,KYG Antler LLC,Brand Publicity,Merf,14214935,7623,231,7392,2022-01-29
1828,Google Inc.,Media Supported Asset,Space Wars,80609518,7602,1594,6008,2022-04-16
1453,TikTok Inc,Influencer,Merf,14554279,7515,2878,4637,2022-03-11
1574,The Martingale Agency,E-Commerce,GI-Bro,96659839,7512,5255,2257,2022-05-31
2948,Disney Studios,E-Commerce,Merf,94350240,7511,2928,4583,2022-06-06
4985,TikTok Inc,E-Commerce,Clay-Dough,15147025,7464,5436,2028,2022-01-12
837,Nintendo Technologies,Brand Asset Development,Clay-Dough,91033103,7431,1570,5861,2022-05-13
4122,Meta Platforms,Brand Asset Development,Transmorphers,38345008,7430,7118,312,2022-06-14
321,KYG Antler LLC,Influencer,GI-Bro,77863717,7395,6205,1190,2022-02-07
1935,KYG Antler LLC,Media Supported Asset,Merf,31649702,7374,1024,6350,2022-01-20
1573,Disney Studios,E-Commerce,GI-Bro,10931325,7334,4209,3125,2022-03-19
4670,The Martingale Agency,Influencer,Space Wars,69830310,7326,5660,1666,2022-02-07
4846,Pinterest Inc,Brand Publicity,Transmorphers,70625534,7275,4310,2965,2022-02-20
2185,Google Inc.,Media Supported Asset,Clay-Dough,94697698,7222,4024,3198,2022-02-13
111,KYG Antler LLC,E-Commerce,Space Wars,43514486,7193,3114,4079,2022-03-04
1677,Meta Platforms,Brand Publicity,Transmorphers,90841575,7176,1870,5306,2022-06-11
1051,The Martingale Agency,Brand Publicity,Merf,79735551,7122,3067,4055,2022-06-25
1251,KYG Antler LLC,Brand Publicity,GI-Bro,27968924,7103,2317,4786,2022-05-25
343,Pinterest Inc,E-Commerce,Clay-Dough,74229497,7004,5331,1673,2022-01-04
3964,Meta Platforms,Brand Publicity,Clay-Dough,98897543,6960,2246,4714,2022-02-25
3972,The Martingale Agency,Media Supported Asset,Clay-Dough,11782236,6954,912,6042,2022-04-01
4831,Google Inc.,Influencer,Transmorphers,87006819,6821,4021,2800,2022-03-01
4715,Nintendo Technologies,E-Commerce,Clay-Dough,57800248,6787,5934,853,2022-05-12
955,Nintendo Technologies,Media Supported Asset,GI-Bro,77635357,6746,1941,4805,2022-06-11
4405,Nintendo Technologies,Brand Publicity,Transmorphers,29390443,6744,2078,4666,2022-04-15
3747,Nintendo Technologies,Brand Asset Development,Merf,47470128,6733,6423,310,2022-03-19
527,TikTok Inc,E-Commerce,Clay-Dough,72449573,6727,804,5923,2022-03-19
4382,The Martingale Agency,Brand Asset Development,GI-Bro,23463458,6691,5232,1459,2022-03-28
2928,Meta Platforms,Brand Publicity,Transmorphers,13070407,6691,4633,2058,2022-02-04
4891,Pinterest Inc,Brand Asset Development,GI-Bro,64405085,6673,5163,1510,2022-04-22
2569,Pinterest Inc,Brand Asset Development,Transmorphers,76716444,6651,860,5791,2022-02-23
3842,Meta Platforms,E-Commerce,Space Wars,99902196,6650,448,6202,2022-06-16
3184,Pinterest Inc,Influencer,Space Wars,96696180,6560,3181,3379,2022-04-23
99,Google Inc.,Media Supported Asset,Clay-Dough,33195487,6399,6245,154,2022-06-25
3368,Pinterest Inc,Influencer,GI-Bro,73967090,6396,2944,3452,2022-03-04
1223,KYG Antler LLC,Influencer,Transmorphers,71096368,6359,4783,1576,2022-04-17
4945,Pinterest Inc,Brand Asset Development,Clay-Dough,69551301,6342,500,5842,2022-01-05
4105,TikTok Inc,Influencer,Transmorphers,37116523,6315,2880,3435,2022-06-19
1772,Nintendo Technologies,Influencer,Merf,88661743,6260,415,5845,2022-03-16
1765,Meta Platforms,Media Supported Asset,Space Wars,63357410,6256,1054,5202,2022-01-19
4214,Google Inc.,Influencer,Merf,47700358,6230,814,5416,2022-02-27
442,Google Inc.,Brand Asset Development,Clay-Dough,31846551,6210,3305,2905,2022-04-14
3517,Meta Platforms,Brand Publicity,Transmorphers,60094013,6208,2833,3375,2022-03-05
4466,Disney Studios,Brand Asset Development,Transmorphers,59399990,6197,404,5793,2022-06-21
4156,Disney Studios,Media Supported Asset,GI-Bro,79271740,6129,2100,4029,2022-06-08
3157,Google Inc.,E-Commerce,Clay-Dough,33191896,6075,5076,999,2022-04-06
3381,KYG Antler LLC,E-Commerce,Transmorphers,50211226,6023,163,5860,2022-04-10
2209,The Martingale Agency,Influencer,GI-Bro,11897274,5958,5561,397,2022-06-17
378,Meta Platforms,Media Supported Asset,GI-Bro,52976592,5949,331,5618,2022-04-01
4281,Meta Platforms,Influencer,Space Wars,16936324,5922,2365,3557,2022-06-12
786,Pinterest Inc,Brand Asset Development,GI-Bro,52421166,5885,4560,1325,2022-06-07
2896,TikTok Inc,Media Supported Asset,GI-Bro,47186158,5846,3643,2203,2022-05-31
3273,Pinterest Inc,Influencer,Merf,27027624,5837,4174,1663,2022-03-17
4068,Pinterest Inc,E-Commerce,Clay-Dough,75758693,5815,4033,1782,2022-06-27
4737,Disney Studios,Media Supported Asset,GI-Bro,38734447,5746,1224,4522,2022-06-17
2889,Disney Studios,Brand Publicity,Merf,21580407,5743,1108,4635,2022-03-25
2413,The Martingale Agency,Brand Asset Development,Transmorphers,17822922,5721,822,4899,2022-02-18
3016,TikTok Inc,Media Supported Asset,GI-Bro,26615868,5696,2967,2729,2022-03-21
4637,Meta Platforms,Brand Asset Development,Space Wars,97622674,5611,1864,3747,2022-03-20
3602,Disney Studios,Brand Publicity,Transmorphers,13900220,5597,4512,1085,2022-04-24
3828,Disney Studios,Influencer,GI-Bro,73537859,5584,3640,1944,2022-02-07
511,TikTok Inc,E-Commerce,Transmorphers,46747562,5579,5410,169,2022-01-28
3649,TikTok Inc,E-Commerce,GI-Bro,55102616,5544,4947,597,2022-04-07
1911,Google Inc.,Brand Publicity,Clay-Dough,73372924,5523,178,5345,2022-05-12
2134,Disney Studios,E-Commerce,Space Wars,74370498,5515,3646,1869,2022-01-20
4876,The Martingale Agency,Influencer,Space Wars,67047234,5464,1596,3868,2022-06-21
246,Google Inc.,Media Supported Asset,Space Wars,39465797,5452,2078,3374,2022-01-21
596,Disney Studios,Influencer,Clay-Dough,56899986,5442,1159,4283,2022-03-14
4629,Meta Platforms,Media Supported Asset,Transmorphers,28307652,5386,4977,409,2022-02-04
2921,Nintendo Technologies,Media Supported Asset,Space Wars,35388970,5378,3878,1500,2022-05-17
2917,Pinterest Inc,Media Supported Asset,GI-Bro,20328020,5361,1658,3703,2022-06-05
625,Nintendo Technologies,Influencer,Transmorphers,92020360,5318,2777,2541,2022-04-15
4182,Disney Studios,Brand Asset Development,GI-Bro,63356116,5275,1246,4029,2022-03-18
979,Nintendo Technologies,Brand Publicity,GI-Bro,57590150,5131,442,4689,2022-01-22
2749,KYG Antler LLC,Brand Publicity,Transmorphers,88190203,5112,4914,198,2022-05-13
3860,Google Inc.,Influencer,GI-Bro,73301829,5110,3465,1645,2022-06-15
1643,Nintendo Technologies,Influencer,Merf,32507237,5021,3769,1252,2022-02-14
391,Meta Platforms,Media Supported Asset,Transmorphers,54972905,4983,3495,1488,2022-06-24
839,Nintendo Technologies,Influencer,GI-Bro,16458653,4937,457,4480,2022-03-07
696,Pinterest Inc,Brand Publicity,Merf,78972805,4920,1610,3310,2022-06-13
272,The Martingale Agency,Brand Publicity,Transmorphers,31437738,4914,3820,1094,2022-05-01
1849,Disney Studios,Brand Publicity,GI-Bro,62696302,4855,4136,719,2022-04-20
816,Disney Studios,Brand Publicity,Merf,83912213,4843,2713,2130,2022-03-30
2810,Nintendo Technologies,E-Commerce,Merf,68510677,4837,3997,840,2022-05-21
3950,The Martingale Agency,Media Supported Asset,GI-Bro,93825127,4819,2209,2610,2022-06-16
806,Disney Studios,E-Commerce,GI-Bro,63335748,4743,3449,1294,2022-05-07
3595,Pinterest Inc,E-Commerce,Transmorphers,74660145,4712,850,3862,2022-01-27
2382,The Martingale Agency,Media Supported Asset,Space Wars,11940237,4711,3976,735,2022-05-02
4615,KYG Antler LLC,Brand Publicity,GI-Bro,78537306,4539,3762,777,2022-01-10
573,Disney Studios,Media Supported Asset,Space Wars,60354453,4534,508,4026,2022-04-24
1876,KYG Antler LLC,Brand Publicity,GI-Bro,83695485,4487,836,3651,2022-05-10
4707,Disney Studios,Brand Publicity,Merf,71069008,4472,1067,3405,2022-02-15
4816,The Martingale Agency,E-Commerce,Merf,56959475,4452,3650,802,2022-01-23
3263,Nintendo Technologies,Influencer,Clay-Dough,81148008,4413,102,4311,2022-02-25
3960,TikTok Inc,E-Commerce,GI-Bro,85661586,4388,3167,1221,2022-01-09
3108,KYG Antler LLC,Influencer,Space Wars,89758810,4343,3965,378,2022-05-15
1996,Google Inc.,Brand Publicity,Merf,38991261,4334,3883,451,2022-04-22
574,Nintendo Technologies,Media Supported Asset,Clay-Dough,36578490,4328,1575,2753,2022-02-01
2216,TikTok Inc,E-Commerce,Clay-Dough,23123448,4304,3352,952,2022-03-26
1443,KYG Antler LLC,Media Supported Asset,GI-Bro,33701926,4269,602,3667,2022-01-11
1752,KYG Antler LLC,E-Commerce,Merf,95795833,4224,868,3356,2022-02-22
4136,The Martingale Agency,Media Supported Asset,GI-Bro,20332637,4182,3292,890,2022-03-29
2364,Nintendo Technologies,Media Supported Asset,Merf,98578093,4177,3774,403,2022-02-28
1770,Pinterest Inc,Media Supported Asset,Merf,49658236,4030,1741,2289,2022-02-27
4471,The Martingale Agency,Brand Publicity,Space Wars,65110955,3988,379,3609,2022-02-20
4544,Meta Platforms,Brand Publicity,Merf,67449189,3984,2187,1797,2022-02-03
2981,Pinterest Inc,Influencer,GI-Bro,10673878,3777,884,2893,2022-04-16
2828,Disney Studios,Media Supported Asset,GI-Bro,45805424,3748,1746,2002,2022-05-27
2689,TikTok Inc,Media Supported Asset,Merf,49819270,3745,2124,1621,2022-03-23
3096,Google Inc.,Brand Publicity,Space Wars,63432232,3702,491,3211,2022-04-22
2479,TikTok Inc,Media Supported Asset,Clay-Dough,17164972,3649,2474,1175,2022-05-30
348,Pinterest Inc,Brand Publicity,GI-Bro,61693449,3487,1743,1744,2022-05-11
847,Disney Studios,Media Supported Asset,GI-Bro,56983223,3455,208,3247,2022-02-01
3051,Nintendo Technologies,Media Supported Asset,Transmorphers,65200625,3353,411,2942,2022-04-09
4649,Meta Platforms,Brand Asset Development,Transmorphers,39641993,3301,2351,950,2022-06-12
169,Google Inc.,Influencer,Transmorphers,10233989,3264,1010,2254,2022-04-26
1749,Google Inc.,Influencer,Space Wars,17466022,3176,3007,169,2022-04-29
4390,Meta Platforms,E-Commerce,GI-Bro,49612288,3155,1201,1954,2022-03-14
705,Meta Platforms,E-Commerce,Transmorphers,46764297,3143,338,2805,2022-03-06
2742,Nintendo Technologies,Brand Asset Development,Merf,39216322,3108,2408,700,2022-03-22
4931,The Martingale Agency,Brand Publicity,Clay-Dough,30985553,3076,2617,459,2022-04-22
1567,The Martingale Agency,Brand Asset Development,Transmorphers,94824255,3060,1760,1300,2022-05-03
3560,KYG Antler LLC,Media Supported Asset,Clay-Dough,31262624,3036,2965,71,2022-02-15
3385,Meta Platforms,Influencer,Merf,87922607,2974,2854,120,2022-04-12
4804,Disney Studios,Brand Publicity,Merf,28710709,2970,294,2676,2022-04-11
3958,TikTok Inc,Media Supported Asset,Space Wars,74428710,2969,318,2651,2022-03-14
3859,Google Inc.,Media Supported Asset,Space Wars,73232022,2918,672,2246,2022-05-28
1521,Disney Studios,E-Commerce,Transmorphers,96022494,2915,2545,370,2022-01-30
2683,Disney Studios,Brand Asset Development,Merf,30099685,2908,1557,1351,2022-05-10
3900,Meta Platforms,Brand Asset Development,Transmorphers,22882222,2896,1054,1842,2022-04-13
4863,Google Inc.,Influencer,Transmorphers,10609047,2892,1370,1522,2022-06-21
4341,KYG Antler LLC,E-Commerce,Transmorphers,67528023,2884,2665,219,2022-06-29
4442,Google Inc.,Brand Asset Development,Clay-Dough,19715647,2771,502,2269,2022-01-30
3710,Pinterest Inc,Media Supported Asset,Merf,64434860,2737,631,2106,2022-01-08
4631,The Martingale Agency,Brand Publicity,Clay-Dough,86339160,2695,1185,1510,2022-06-10
2618,TikTok Inc,Brand Publicity,Space Wars,27412452,2492,1983,509,2022-05-14
2503,KYG Antler LLC,Influencer,Space Wars,68230199,2477,455,2022,2022-06-27
2515,Disney Studios,E-Commerce,Clay-Dough,18330300,2445,1776,669,2022-05-06
241,KYG Antler LLC,Brand Publicity,Transmorphers,89930544,2413,2210,203,2022-02-24
2971,Google Inc.,Influencer,GI-Bro,56950444,2365,229,2136,2022-03-02
4741,Google Inc.,Brand Asset Development,Merf,51236983,2339,1175,1164,2022-06-09
1063,Nintendo Technologies,Media Supported Asset,Merf,42366855,2258,1069,1189,2022-06-21
3480,Nintendo Technologies,Media Supported Asset,Clay-Dough,14907961,2209,1857,352,2022-06-20
3153,Nintendo Technologies,E-Commerce,Merf,68316829,2174,2125,49,2022-04-27
840,Meta Platforms,Brand Asset Development,Transmorphers,83084007,2170,1013,1157,2022-01-11
2800,TikTok Inc,Influencer,Merf,37422541,2156,524,1632,2022-05-29
2180,The Martingale Agency,Brand Publicity,Clay-Dough,18515078,2149,1767,382,2022-02-16
807,TikTok Inc,Media Supported Asset,GI-Bro,49454597,2039,1523,516,2022-01-07
214,Nintendo Technologies,Brand Publicity,Merf,58452227,2017,28,1989,2022-04-16
4229,TikTok Inc,Media Supported Asset,Clay-Dough,40161951,2013,854,1159,2022-05-01
3335,Pinterest Inc,Influencer,GI-Bro,99472071,1969,716,1253,2022-01-06
3884,The Martingale Agency,E-Commerce,GI-Bro,34934622,1937,1873,64,2022-02-23
4130,KYG Antler LLC,E-Commerce,GI-Bro,32738693,1927,1301,626,2022-03-21
850,Disney Studios,Media Supported Asset,Space Wars,28130650,1800,230,1570,2022-04-29
1106,TikTok Inc,Media Supported Asset,Clay-Dough,60264742,1696,76,1620,2022-03-30
2638,Disney Studios,Brand Publicity,GI-Bro,69243262,1691,1064,627,2022-04-07
2169,Google Inc.,Media Supported Asset,Clay-Dough,94839516,1666,1173,493,2022-03-22
2234,KYG Antler LLC,Media Supported Asset,Space Wars,68177644,1656,559,1097,2022-05-09
1657,Pinterest Inc,Brand Publicity,Space Wars,33598289,1549,1229,320,2022-06-20
4562,Google Inc.,Brand Asset Development,Clay-Dough,87182766,1539,1282,257,2022-02-26
2429,Nintendo Technologies,Influencer,Clay-Dough,25865935,1479,7,1472,2022-01-27
2782,Disney Studios,Brand Publicity,GI-Bro,54871145,1451,1379,72,2022-03-23
968,TikTok Inc,Brand Asset Development,Merf,53845641,1403,290,1113,2022-05-27
4227,Meta Platforms,E-Commerce,Merf,98208365,1390,78,1312,2022-03-27
2319,Google Inc.,Brand Asset Development,GI-Bro,48279650,1350,738,612,2022-06-10
3175,TikTok Inc,Brand Asset Development,Clay-Dough,32623329,1321,43,1278,2022-01-01
1248,Google Inc.,E-Commerce,Clay-Dough,23551055,1321,1018,303,2022-04-29
2804,KYG Antler LLC,Brand Publicity,Transmorphers,68947926,1297,1075,222,2022-02-03
4806,KYG Antler LLC,Influencer,Space Wars,56220933,1242,747,495,2022-05-01
3946,Meta Platforms,Media Supported Asset,Merf,26461882,1204,1132,72,2022-01-29
2496,Meta Platforms,E-Commerce,Transmorphers,47034085,1160,1159,1,2022-05-29
3490,TikTok Inc,Brand Publicity,Transmorphers,50114875,1132,1108,24,2022-05-29
4828,Pinterest Inc,Media Supported Asset,Merf,37112033,1118,656,462,2022-02-09
482,Meta Platforms,Media Supported Asset,Space Wars,81022930,1092,784,308,2022-02-13
4488,Disney Studios,Influencer,Transmorphers,13372486,1075,1010,65,2022-01-19
1012,TikTok Inc,Media Supported Asset,GI-Bro,48457522,1031,785,246,2022-01-28
921,Nintendo Technologies,Brand Publicity,Transmorphers,87333875,1019,602,417,2022-04-02
2741,Disney Studios,Brand Asset Development,GI-Bro,48339709,1015,205,810,2022-03-16
3583,TikTok Inc,Media Supported Asset,GI-Bro,87569185,960,53,907,2022-02-16
4895,The Martingale Agency,Influencer,Space Wars,88076032,828,300,528,2022-04-26
2348,The Martingale Agency,E-Commerce,GI-Bro,80524379,817,146,671,2022-04-29
2032,Google Inc.,Brand Asset Development,GI-Bro,25881193,802,210,592,2022-01-06
4053,Nintendo Technologies,Influencer,Transmorphers,43099871,777,765,12,2022-06-29
951,KYG Antler LLC,E-Commerce,Transmorphers,66715080,761,72,689,2022-03-14
4364,Disney Studios,Brand Asset Development,Merf,11896033,755,202,553,2022-05-30
4569,KYG Antler LLC,Influencer,Transmorphers,62020809,728,351,377,2022-02-15
793,Nintendo Technologies,Media Supported Asset,Space Wars,66540773,702,412,290,2022-05-14
2131,Meta Platforms,Media Supported Asset,Clay-Dough,30289867,698,316,382,2022-05-10
4596,Meta Platforms,Brand Publicity,Merf,70709627,689,21,668,2022-01-16
2583,Meta Platforms,Brand Publicity,Clay-Dough,20907028,663,290,373,2022-03-22
2046,KYG Antler LLC,Brand Asset Development,Clay-Dough,34365677,594,421,173,2022-04-25
1624,Disney Studios,Brand Asset Development,Clay-Dough,33731774,548,165,383,2022-05-28
4514,KYG Antler LLC,Brand Publicity,Merf,27628295,477,313,164,2022-06-11
639,Disney Studios,E-Commerce,Merf,63530873,427,291,136,2022-02-17
3883,Nintendo Technologies,Brand Publicity,Merf,31557329,400,92,308,2022-01-15
3829,Nintendo Technologies,Brand Publicity,Clay-Dough,54873153,352,253,99,2022-03-20
3587,TikTok Inc,Brand Asset Development,Clay-Dough,41366627,328,37,291,2022-06-25
2097,Meta Platforms,Influencer,Merf,86046400,232,50,182,2022-03-16
